學年度,設立別,學校類別,學校統計處代碼,學校名稱,學制班別,在學學生數小計,在學學生數男,在學學生數女
106,公立,一般大學,0001,國立政治大學,學士班(日間),9632,3934,5698
106,公立,一般大學,0001,國立政治大學,碩士班(日間),4028,1846,2182
106,公立,一般大學,0001,國立政治大學,碩士在職專班,1741,871,870
106,公立,一般大學,0001,國立政治大學,博士班,952,565,387
106,公立,一般大學,0002,國立清華大學,學士班(日間),8892,4758,4134
106,公立,一般大學,0002,國立清華大學,碩士班(日間),4955,3100,1855
106,公立,一般大學,0002,國立清華大學,碩士在職專班,1130,423,707
106,公立,一般大學,0002,國立清華大學,博士班,1687,1253,434
106,公立,一般大學,0003,國立臺灣大學,學士班(日間),16557,9393,7164
106,公立,一般大學,0003,國立臺灣大學,學士班(進修),1,1,0
106,公立,一般大學,0003,國立臺灣大學,碩士班(日間),10201,6188,4013
106,公立,一般大學,0003,國立臺灣大學,碩士在職專班,1427,930,497
106,公立,一般大學,0003,國立臺灣大學,博士班,3616,2542,1074
106,公立,一般大學,0004,國立臺灣師範大學,學士班(日間),8085,3584,4501
106,公立,一般大學,0004,國立臺灣師範大學,碩士班(日間),3956,1635,2321
106,公立,一般大學,0004,國立臺灣師範大學,碩士在職專班,1992,584,1408
106,公立,一般大學,0004,國立臺灣師範大學,博士班,1393,711,682
106,公立,一般大學,0005,國立成功大學,學士班(日間),11481,7210,4271
106,公立,一般大學,0005,國立成功大學,碩士班(日間),6595,4138,2457
106,公立,一般大學,0005,國立成功大學,碩士在職專班,1343,855,488
106,公立,一般大學,0005,國立成功大學,博士班,1833,1287,546
106,公立,一般大學,0006,國立中興大學,學士班(日間),8073,4733,3340
106,公立,一般大學,0006,國立中興大學,學士班(進修),950,401,549
106,公立,一般大學,0006,國立中興大學,碩士班(日間),3321,1994,1327
106,公立,一般大學,0006,國立中興大學,碩士在職專班,1544,1028,516
106,公立,一般大學,0006,國立中興大學,博士班,989,703,286
106,公立,一般大學,0007,國立交通大學,學士班(日間),5455,3815,1640
106,公立,一般大學,0007,國立交通大學,碩士班(日間),5543,3815,1728
106,公立,一般大學,0007,國立交通大學,碩士在職專班,1470,1029,441
106,公立,一般大學,0007,國立交通大學,博士班,1701,1359,342
106,公立,一般大學,0008,國立中央大學,學士班(日間),6117,3917,2200
106,公立,一般大學,0008,國立中央大學,碩士班(日間),3448,2289,1159
106,公立,一般大學,0008,國立中央大學,碩士在職專班,1325,831,494
106,公立,一般大學,0008,國立中央大學,博士班,1034,760,274
106,公立,一般大學,0009,國立中山大學,學士班(日間),4740,2952,1788
106,公立,一般大學,0009,國立中山大學,碩士班(日間),2901,1818,1083
106,公立,一般大學,0009,國立中山大學,碩士在職專班,1027,522,505
106,公立,一般大學,0009,國立中山大學,博士班,798,545,253
106,公立,一般大學,0012,國立臺灣海洋大學,學士班(日間),5737,3986,1751
106,公立,一般大學,0012,國立臺灣海洋大學,學士班(進修),664,410,254
106,公立,一般大學,0012,國立臺灣海洋大學,碩士班(日間),1393,920,473
106,公立,一般大學,0012,國立臺灣海洋大學,碩士在職專班,566,350,216
106,公立,一般大學,0012,國立臺灣海洋大學,博士班,292,223,69
106,公立,一般大學,0013,國立中正大學,學士班(日間),6728,3670,3058
106,公立,一般大學,0013,國立中正大學,碩士班(日間),2826,1764,1062
106,公立,一般大學,0013,國立中正大學,碩士在職專班,1370,658,712
106,公立,一般大學,0013,國立中正大學,博士班,588,400,188
106,公立,一般大學,0014,國立高雄師範大學,學士班(日間),3487,1657,1830
106,公立,一般大學,0014,國立高雄師範大學,碩士班(日間),1378,505,873
106,公立,一般大學,0014,國立高雄師範大學,碩士在職專班,1339,463,876
106,公立,一般大學,0014,國立高雄師範大學,博士班,450,225,225
106,公立,一般大學,0015,國立彰化師範大學,學士班(日間),4895,2540,2355
106,公立,一般大學,0015,國立彰化師範大學,碩士班(日間),1510,762,748
106,公立,一般大學,0015,國立彰化師範大學,碩士在職專班,1353,594,759
106,公立,一般大學,0015,國立彰化師範大學,博士班,477,286,191
106,公立,一般大學,0016,國立陽明大學,學士班(日間),2107,1160,947
106,公立,一般大學,0016,國立陽明大學,碩士班(日間),1226,493,733
106,公立,一般大學,0016,國立陽明大學,碩士在職專班,135,43,92
106,公立,一般大學,0016,國立陽明大學,博士班,864,503,361
106,公立,一般大學,0017,國立臺北大學,學士班(日間),5878,2674,3204
106,公立,一般大學,0017,國立臺北大學,學士班(進修),1959,752,1207
106,公立,一般大學,0017,國立臺北大學,碩士班(日間),1346,667,679
106,公立,一般大學,0017,國立臺北大學,碩士在職專班,456,205,251
106,公立,一般大學,0017,國立臺北大學,博士班,214,142,72
106,公立,一般大學,0018,國立嘉義大學,學士班(日間),7830,4036,3794
106,公立,一般大學,0018,國立嘉義大學,學士班(進修),2095,1264,831
106,公立,一般大學,0018,國立嘉義大學,碩士班(日間),1355,621,734
106,公立,一般大學,0018,國立嘉義大學,碩士在職專班,938,386,552
106,公立,一般大學,0018,國立嘉義大學,博士班,181,98,83
106,公立,一般大學,0019,國立高雄大學,學士班(日間),4193,2379,1814
106,公立,一般大學,0019,國立高雄大學,學士班(進修),170,106,64
106,公立,一般大學,0019,國立高雄大學,碩士班(日間),646,420,226
106,公立,一般大學,0019,國立高雄大學,碩士在職專班,473,303,170
106,公立,一般大學,0019,國立高雄大學,博士班,24,22,2
106,公立,一般大學,0020,國立東華大學,學士班(日間),7659,3747,3912
106,公立,一般大學,0020,國立東華大學,碩士班(日間),1582,826,756
106,公立,一般大學,0020,國立東華大學,碩士在職專班,567,261,306
106,公立,一般大學,0020,國立東華大學,博士班,346,224,122
106,公立,一般大學,0021,國立暨南國際大學,學士班(日間),4675,2194,2481
106,公立,一般大學,0021,國立暨南國際大學,碩士班(日間),903,462,441
106,公立,一般大學,0021,國立暨南國際大學,碩士在職專班,437,202,235
106,公立,一般大學,0021,國立暨南國際大學,博士班,346,196,150
106,公立,技專校院,0022,國立臺灣科技大學,學士班(日間),5729,3955,1774
106,公立,技專校院,0022,國立臺灣科技大學,學士班(進修),11,1,10
106,公立,技專校院,0022,國立臺灣科技大學,碩士班(日間),3469,2442,1027
106,公立,技專校院,0022,國立臺灣科技大學,碩士在職專班,786,531,255
106,公立,技專校院,0022,國立臺灣科技大學,博士班,1024,816,208
106,公立,技專校院,0023,國立雲林科技大學,學士班(日間),6541,3877,2664
106,公立,技專校院,0023,國立雲林科技大學,學士班(進修),45,22,23
106,公立,技專校院,0023,國立雲林科技大學,碩士班(日間),1973,1271,702
106,公立,技專校院,0023,國立雲林科技大學,碩士在職專班,727,414,313
106,公立,技專校院,0023,國立雲林科技大學,博士班,429,285,144
106,公立,技專校院,0024,國立屏東科技大學,學士班(日間),7786,4052,3734
106,公立,技專校院,0024,國立屏東科技大學,學士班(進修),1521,807,714
106,公立,技專校院,0024,國立屏東科技大學,碩士班(日間),1153,689,464
106,公立,技專校院,0024,國立屏東科技大學,碩士在職專班,475,329,146
106,公立,技專校院,0024,國立屏東科技大學,博士班,252,167,85
106,公立,技專校院,0025,國立臺北科技大學,學士班(日間),6067,4200,1867
106,公立,技專校院,0025,國立臺北科技大學,學士班(進修),1927,1546,381
106,公立,技專校院,0025,國立臺北科技大學,碩士班(日間),2783,2097,686
106,公立,技專校院,0025,國立臺北科技大學,碩士在職專班,1474,1071,403
106,公立,技專校院,0025,國立臺北科技大學,博士班,722,576,146
106,公立,技專校院,0026,國立高雄第一科技大學,學士班(日間),5811,2942,2869
106,公立,技專校院,0026,國立高雄第一科技大學,碩士班(日間),1052,645,407
106,公立,技專校院,0026,國立高雄第一科技大學,碩士在職專班,714,502,212
106,公立,技專校院,0026,國立高雄第一科技大學,博士班,227,175,52
106,公立,技專校院,0027,國立高雄應用科技大學,學士班(日間),7380,4777,2603
106,公立,技專校院,0027,國立高雄應用科技大學,學士班(進修),1849,1156,693
106,公立,技專校院,0027,國立高雄應用科技大學,碩士班(日間),1171,831,340
106,公立,技專校院,0027,國立高雄應用科技大學,碩士在職專班,1132,717,415
106,公立,技專校院,0027,國立高雄應用科技大學,博士班,290,239,51
106,公立,一般大學,0028,國立臺北藝術大學,七年一貫,75,34,41
106,公立,一般大學,0028,國立臺北藝術大學,學士班(日間),1821,642,1179
106,公立,一般大學,0028,國立臺北藝術大學,碩士班(日間),956,350,606
106,公立,一般大學,0028,國立臺北藝術大學,碩士在職專班,193,66,127
106,公立,一般大學,0028,國立臺北藝術大學,博士班,86,27,59
106,公立,一般大學,0029,國立臺灣藝術大學,學士班(日間),2438,699,1739
106,公立,一般大學,0029,國立臺灣藝術大學,學士班(進修),1950,596,1354
106,公立,一般大學,0029,國立臺灣藝術大學,碩士班(日間),754,273,481
106,公立,一般大學,0029,國立臺灣藝術大學,碩士在職專班,429,171,258
106,公立,一般大學,0029,國立臺灣藝術大學,博士班,112,54,58
106,公立,一般大學,0030,國立臺東大學,學士班(日間),3526,1732,1794
106,公立,一般大學,0030,國立臺東大學,學士班(進修),173,78,95
106,公立,一般大學,0030,國立臺東大學,碩士班(日間),334,136,198
106,公立,一般大學,0030,國立臺東大學,碩士在職專班,542,158,384
106,公立,一般大學,0030,國立臺東大學,博士班,41,14,27
106,公立,一般大學,0031,國立宜蘭大學,學士班(日間),4450,2886,1564
106,公立,一般大學,0031,國立宜蘭大學,學士班(進修),378,255,123
106,公立,一般大學,0031,國立宜蘭大學,碩士班(日間),474,329,145
106,公立,一般大學,0031,國立宜蘭大學,碩士在職專班,197,141,56
106,公立,一般大學,0031,國立宜蘭大學,博士班,12,10,2
106,公立,一般大學,0032,國立聯合大學,學士班(日間),6051,4169,1882
106,公立,一般大學,0032,國立聯合大學,學士班(進修),1253,746,507
106,公立,一般大學,0032,國立聯合大學,碩士班(日間),410,289,121
106,公立,一般大學,0032,國立聯合大學,碩士在職專班,3,1,2
106,公立,一般大學,0032,國立聯合大學,博士班,12,12,0
106,公立,技專校院,0033,國立虎尾科技大學,學士班(日間),7416,5597,1819
106,公立,技專校院,0033,國立虎尾科技大學,學士班(進修),1685,1321,364
106,公立,技專校院,0033,國立虎尾科技大學,碩士班(日間),855,683,172
106,公立,技專校院,0033,國立虎尾科技大學,碩士在職專班,199,142,57
106,公立,技專校院,0033,國立虎尾科技大學,博士班,33,25,8
106,公立,技專校院,0034,國立高雄海洋科技大學,五專,508,422,86
106,公立,技專校院,0034,國立高雄海洋科技大學,學士班(日間),4835,3171,1664
106,公立,技專校院,0034,國立高雄海洋科技大學,學士班(進修),1837,1282,555
106,公立,技專校院,0034,國立高雄海洋科技大學,碩士班(日間),317,204,113
106,公立,技專校院,0034,國立高雄海洋科技大學,碩士在職專班,169,124,45
106,公立,技專校院,0034,國立高雄海洋科技大學,博士班,28,22,6
106,公立,一般大學,0035,國立臺南藝術大學,七年一貫,170,67,103
106,公立,一般大學,0035,國立臺南藝術大學,學士班(日間),784,235,549
106,公立,一般大學,0035,國立臺南藝術大學,碩士班(日間),540,196,344
106,公立,一般大學,0035,國立臺南藝術大學,碩士在職專班,48,16,32
106,公立,一般大學,0035,國立臺南藝術大學,博士班,38,19,19
106,公立,一般大學,0036,國立臺南大學,學士班(日間),3879,1786,2093
106,公立,一般大學,0036,國立臺南大學,學士班(進修),70,20,50
106,公立,一般大學,0036,國立臺南大學,碩士班(日間),940,427,513
106,公立,一般大學,0036,國立臺南大學,碩士在職專班,683,233,450
106,公立,一般大學,0036,國立臺南大學,博士班,173,80,93
106,公立,一般大學,0037,國立臺北教育大學,學士班(日間),3383,1180,2203
106,公立,一般大學,0037,國立臺北教育大學,碩士班(日間),1256,417,839
106,公立,一般大學,0037,國立臺北教育大學,碩士在職專班,1019,237,782
106,公立,一般大學,0037,國立臺北教育大學,博士班,150,70,80
106,公立,一般大學,0039,國立臺中教育大學,學士班(日間),3351,1194,2157
106,公立,一般大學,0039,國立臺中教育大學,碩士班(日間),818,281,537
106,公立,一般大學,0039,國立臺中教育大學,碩士在職專班,713,176,537
106,公立,一般大學,0039,國立臺中教育大學,博士班,124,57,67
106,公立,技專校院,0042,國立澎湖科技大學,學士班(日間),2569,1506,1063
106,公立,技專校院,0042,國立澎湖科技大學,學士班(進修),304,138,166
106,公立,技專校院,0042,國立澎湖科技大學,碩士班(日間),86,46,40
106,公立,技專校院,0042,國立澎湖科技大學,碩士在職專班,49,28,21
106,公立,技專校院,0043,國立勤益科技大學,二專(日間),1,1,0
106,公立,技專校院,0043,國立勤益科技大學,學士班(日間),6727,4613,2114
106,公立,技專校院,0043,國立勤益科技大學,學士班(進修),3599,2948,651
106,公立,技專校院,0043,國立勤益科技大學,碩士班(日間),546,423,123
106,公立,技專校院,0043,國立勤益科技大學,碩士在職專班,285,236,49
106,公立,技專校院,0043,國立勤益科技大學,博士班,18,16,2
106,公立,一般大學,0044,國立體育大學,學士班(日間),1659,1035,624
106,公立,一般大學,0044,國立體育大學,學士班(進修),100,70,30
106,公立,一般大學,0044,國立體育大學,碩士班(日間),356,179,177
106,公立,一般大學,0044,國立體育大學,碩士在職專班,204,110,94
106,公立,一般大學,0044,國立體育大學,博士班,145,96,49
106,公立,技專校院,0046,國立臺北護理健康大學,學士班(日間),3530,685,2845
106,公立,技專校院,0046,國立臺北護理健康大學,學士班(進修),717,18,699
106,公立,技專校院,0046,國立臺北護理健康大學,碩士班(日間),571,107,464
106,公立,技專校院,0046,國立臺北護理健康大學,碩士在職專班,192,26,166
106,公立,技專校院,0046,國立臺北護理健康大學,博士班,67,3,64
106,公立,技專校院,0047,國立高雄餐旅大學,二專(進修),141,52,89
106,公立,技專校院,0047,國立高雄餐旅大學,五專,229,86,143
106,公立,技專校院,0047,國立高雄餐旅大學,學士班(日間),3280,912,2368
106,公立,技專校院,0047,國立高雄餐旅大學,學士班(進修),1393,369,1024
106,公立,技專校院,0047,國立高雄餐旅大學,碩士班(日間),139,41,98
106,公立,技專校院,0047,國立高雄餐旅大學,碩士在職專班,55,33,22
106,公立,技專校院,0047,國立高雄餐旅大學,博士班,30,17,13
106,公立,一般大學,0048,國立金門大學,學士班(日間),3367,1748,1619
106,公立,一般大學,0048,國立金門大學,學士班(進修),846,488,358
106,公立,一般大學,0048,國立金門大學,碩士班(日間),202,130,72
106,公立,一般大學,0048,國立金門大學,碩士在職專班,86,61,25
106,公立,一般大學,0049,國立臺灣體育運動大學,學士班(日間),2455,1475,980
106,公立,一般大學,0049,國立臺灣體育運動大學,學士班(進修),344,250,94
106,公立,一般大學,0049,國立臺灣體育運動大學,碩士班(日間),252,137,115
106,公立,一般大學,0049,國立臺灣體育運動大學,碩士在職專班,103,59,44
106,公立,技專校院,0050,國立臺中科技大學,二專(日間),2,0,2
106,公立,技專校院,0050,國立臺中科技大學,二專(進修),80,5,75
106,公立,技專校院,0050,國立臺中科技大學,五專,3504,711,2793
106,公立,技專校院,0050,國立臺中科技大學,學士班(日間),6860,1831,5029
106,公立,技專校院,0050,國立臺中科技大學,學士班(進修),2594,842,1752
106,公立,技專校院,0050,國立臺中科技大學,碩士班(日間),365,160,205
106,公立,技專校院,0050,國立臺中科技大學,碩士在職專班,194,83,111
106,公立,技專校院,0051,國立臺北商業大學,二專(進修),8,4,4
106,公立,技專校院,0051,國立臺北商業大學,五專,1911,490,1421
106,公立,技專校院,0051,國立臺北商業大學,學士班(日間),3098,813,2285
106,公立,技專校院,0051,國立臺北商業大學,學士班(進修),1500,451,1049
106,公立,技專校院,0051,國立臺北商業大學,碩士班(日間),174,79,95
106,公立,技專校院,0051,國立臺北商業大學,碩士在職專班,39,19,20
106,公立,一般大學,0052,國立屏東大學,學士班(日間),6776,2704,4072
106,公立,一般大學,0052,國立屏東大學,學士班(進修),651,304,347
106,公立,一般大學,0052,國立屏東大學,碩士班(日間),932,394,538
106,公立,一般大學,0052,國立屏東大學,碩士在職專班,556,149,407
106,公立,一般大學,0052,國立屏東大學,博士班,48,27,21
106,公立,技專校院,0144,國立臺灣戲曲學院,學士班(日間),555,190,365
106,公立,技專校院,0144,國立臺灣戲曲學院,學士班(進修),59,28,31
106,公立,技專校院,0221,國立臺南護理專科學校,二專(日間),97,5,92
106,公立,技專校院,0221,國立臺南護理專科學校,二專(進修),61,7,54
106,公立,技專校院,0221,國立臺南護理專科學校,五專,1797,128,1669
106,公立,技專校院,0222,國立臺東專科學校,二專(日間),579,439,140
106,公立,技專校院,0222,國立臺東專科學校,二專(進修),78,41,37
106,公立,技專校院,0222,國立臺東專科學校,五專,587,267,320
106,私立,一般大學,1001,東海大學,學士班(日間),13588,6192,7396
106,私立,一般大學,1001,東海大學,學士班(進修),548,297,251
106,私立,一般大學,1001,東海大學,碩士班(日間),1308,666,642
106,私立,一般大學,1001,東海大學,碩士在職專班,745,371,374
106,私立,一般大學,1001,東海大學,博士班,240,136,104
106,私立,一般大學,1002,輔仁大學,學士班(日間),18105,7746,10359
106,私立,一般大學,1002,輔仁大學,學士班(進修),4630,1698,2932
106,私立,一般大學,1002,輔仁大學,碩士班(日間),2156,903,1253
106,私立,一般大學,1002,輔仁大學,碩士在職專班,1653,688,965
106,私立,一般大學,1002,輔仁大學,博士班,473,252,221
106,私立,一般大學,1003,東吳大學,學士班(日間),12185,4845,7340
106,私立,一般大學,1003,東吳大學,學士班(進修),1104,345,759
106,私立,一般大學,1003,東吳大學,碩士班(日間),1269,577,692
106,私立,一般大學,1003,東吳大學,碩士在職專班,1170,537,633
106,私立,一般大學,1003,東吳大學,博士班,122,65,57
106,私立,一般大學,1004,中原大學,學士班(日間),13524,7480,6044
106,私立,一般大學,1004,中原大學,碩士班(日間),1620,993,627
106,私立,一般大學,1004,中原大學,碩士在職專班,862,547,315
106,私立,一般大學,1004,中原大學,博士班,336,241,95
106,私立,一般大學,1005,淡江大學,學士班(日間),20889,10624,10265
106,私立,一般大學,1005,淡江大學,學士班(進修),1746,931,815
106,私立,一般大學,1005,淡江大學,碩士班(日間),1873,1067,806
106,私立,一般大學,1005,淡江大學,碩士在職專班,1082,559,523
106,私立,一般大學,1005,淡江大學,博士班,442,295,147
106,私立,一般大學,1006,中國文化大學,學士班(日間),21364,10102,11262
106,私立,一般大學,1006,中國文化大學,學士班(進修),1892,802,1090
106,私立,一般大學,1006,中國文化大學,碩士班(日間),1596,885,711
106,私立,一般大學,1006,中國文化大學,碩士在職專班,509,205,304
106,私立,一般大學,1006,中國文化大學,博士班,524,337,187
106,私立,一般大學,1007,逢甲大學,學士班(日間),17029,10582,6447
106,私立,一般大學,1007,逢甲大學,學士班(進修),915,502,413
106,私立,一般大學,1007,逢甲大學,碩士班(日間),1642,1133,509
106,私立,一般大學,1007,逢甲大學,碩士在職專班,1120,706,414
106,私立,一般大學,1007,逢甲大學,博士班,440,325,115
106,私立,一般大學,1008,靜宜大學,學士班(日間),11371,4379,6992
106,私立,一般大學,1008,靜宜大學,學士班(進修),4,1,3
106,私立,一般大學,1008,靜宜大學,碩士班(日間),546,200,346
106,私立,一般大學,1008,靜宜大學,碩士在職專班,326,139,187
106,私立,一般大學,1008,靜宜大學,博士班,42,26,16
106,私立,一般大學,1009,長庚大學,學士班(日間),5304,2750,2554
106,私立,一般大學,1009,長庚大學,碩士班(日間),1160,601,559
106,私立,一般大學,1009,長庚大學,碩士在職專班,198,95,103
106,私立,一般大學,1009,長庚大學,博士班,525,361,164
106,私立,一般大學,1010,元智大學,學士班(日間),7209,4094,3115
106,私立,一般大學,1010,元智大學,碩士班(日間),955,631,324
106,私立,一般大學,1010,元智大學,碩士在職專班,686,448,238
106,私立,一般大學,1010,元智大學,博士班,285,206,79
106,私立,一般大學,1011,中華大學,學士班(日間),5427,3366,2061
106,私立,一般大學,1011,中華大學,學士班(進修),408,254,154
106,私立,一般大學,1011,中華大學,碩士班(日間),550,334,216
106,私立,一般大學,1011,中華大學,碩士在職專班,242,146,96
106,私立,一般大學,1011,中華大學,博士班,95,73,22
106,私立,一般大學,1012,大葉大學,學士班(日間),8623,4520,4103
106,私立,一般大學,1012,大葉大學,學士班(進修),1218,686,532
106,私立,一般大學,1012,大葉大學,碩士班(日間),672,401,271
106,私立,一般大學,1012,大葉大學,碩士在職專班,500,172,328
106,私立,一般大學,1012,大葉大學,博士班,134,108,26
106,私立,一般大學,1013,華梵大學,學士班(日間),1864,1002,862
106,私立,一般大學,1013,華梵大學,碩士班(日間),262,141,121
106,私立,一般大學,1013,華梵大學,碩士在職專班,136,52,84
106,私立,一般大學,1013,華梵大學,博士班,58,34,24
106,私立,一般大學,1014,義守大學,學士班(日間),12853,6580,6273
106,私立,一般大學,1014,義守大學,學士班(進修),2258,1398,860
106,私立,一般大學,1014,義守大學,碩士班(日間),442,277,165
106,私立,一般大學,1014,義守大學,碩士在職專班,519,378,141
106,私立,一般大學,1014,義守大學,博士班,137,105,32
106,私立,一般大學,1015,世新大學,學士班(日間),9873,3504,6369
106,私立,一般大學,1015,世新大學,學士班(進修),338,132,206
106,私立,一般大學,1015,世新大學,碩士班(日間),617,308,309
106,私立,一般大學,1015,世新大學,碩士在職專班,806,459,347
106,私立,一般大學,1015,世新大學,博士班,89,44,45
106,私立,一般大學,1016,銘傳大學,學士班(日間),17521,6920,10601
106,私立,一般大學,1016,銘傳大學,碩士班(日間),730,326,404
106,私立,一般大學,1016,銘傳大學,碩士在職專班,809,359,450
106,私立,一般大學,1016,銘傳大學,博士班,69,29,40
106,私立,一般大學,1017,實踐大學,學士班(日間),11783,3967,7816
106,私立,一般大學,1017,實踐大學,學士班(進修),2256,680,1576
106,私立,一般大學,1017,實踐大學,碩士班(日間),351,162,189
106,私立,一般大學,1017,實踐大學,碩士在職專班,165,74,91
106,私立,一般大學,1017,實踐大學,博士班,24,11,13
106,私立,技專校院,1018,朝陽科技大學,學士班(日間),11448,4780,6668
106,私立,技專校院,1018,朝陽科技大學,學士班(進修),3138,1599,1539
106,私立,技專校院,1018,朝陽科技大學,碩士班(日間),674,384,290
106,私立,技專校院,1018,朝陽科技大學,碩士在職專班,442,235,207
106,私立,技專校院,1018,朝陽科技大學,博士班,90,72,18
106,私立,一般大學,1019,高雄醫學大學,學士班(日間),5605,2536,3069
106,私立,一般大學,1019,高雄醫學大學,學士班(進修),45,1,44
106,私立,一般大學,1019,高雄醫學大學,碩士班(日間),678,236,442
106,私立,一般大學,1019,高雄醫學大學,碩士在職專班,230,86,144
106,私立,一般大學,1019,高雄醫學大學,博士班,323,174,149
106,私立,一般大學,1020,南華大學,學士班(日間),4284,2028,2256
106,私立,一般大學,1020,南華大學,學士班(進修),336,198,138
106,私立,一般大學,1020,南華大學,碩士班(日間),592,254,338
106,私立,一般大學,1020,南華大學,碩士在職專班,356,144,212
106,私立,一般大學,1020,南華大學,博士班,32,20,12
106,私立,一般大學,1021,真理大學,學士班(日間),6321,3060,3261
106,私立,一般大學,1021,真理大學,學士班(進修),280,163,117
106,私立,一般大學,1021,真理大學,碩士班(日間),152,87,65
106,私立,一般大學,1021,真理大學,碩士在職專班,20,10,10
106,私立,一般大學,1022,大同大學,學士班(日間),3744,2345,1399
106,私立,一般大學,1022,大同大學,碩士班(日間),362,242,120
106,私立,一般大學,1022,大同大學,碩士在職專班,287,221,66
106,私立,一般大學,1022,大同大學,博士班,104,64,40
106,私立,技專校院,1023,南臺學校財團法人南臺科技大學,學士班(日間),13194,7307,5887
106,私立,技專校院,1023,南臺學校財團法人南臺科技大學,學士班(進修),4302,2537,1765
106,私立,技專校院,1023,南臺學校財團法人南臺科技大學,碩士班(日間),871,502,369
106,私立,技專校院,1023,南臺學校財團法人南臺科技大學,碩士在職專班,403,216,187
106,私立,技專校院,1023,南臺學校財團法人南臺科技大學,博士班,85,72,13
106,私立,技專校院,1024,崑山科技大學,學士班(日間),8042,4756,3286
106,私立,技專校院,1024,崑山科技大學,學士班(進修),3498,2303,1195
106,私立,技專校院,1024,崑山科技大學,碩士班(日間),424,287,137
106,私立,技專校院,1024,崑山科技大學,碩士在職專班,176,133,43
106,私立,技專校院,1024,崑山科技大學,博士班,34,25,9
106,私立,技專校院,1025,嘉藥學校財團法人嘉南藥理大學,學士班(日間),12260,5072,7188
106,私立,技專校院,1025,嘉藥學校財團法人嘉南藥理大學,學士班(進修),2961,1376,1585
106,私立,技專校院,1025,嘉藥學校財團法人嘉南藥理大學,碩士班(日間),237,115,122
106,私立,技專校院,1025,嘉藥學校財團法人嘉南藥理大學,碩士在職專班,244,121,123
106,私立,技專校院,1026,樹德科技大學,學士班(日間),7981,3413,4568
106,私立,技專校院,1026,樹德科技大學,學士班(進修),1957,946,1011
106,私立,技專校院,1026,樹德科技大學,碩士班(日間),295,158,137
106,私立,技專校院,1026,樹德科技大學,碩士在職專班,439,221,218
106,私立,技專校院,1026,樹德科技大學,博士班,27,9,18
106,私立,一般大學,1027,慈濟學校財團法人慈濟大學,學士班(日間),2963,1136,1827
106,私立,一般大學,1027,慈濟學校財團法人慈濟大學,碩士班(日間),350,124,226
106,私立,一般大學,1027,慈濟學校財團法人慈濟大學,碩士在職專班,37,6,31
106,私立,一般大學,1027,慈濟學校財團法人慈濟大學,博士班,110,59,51
106,私立,一般大學,1028,臺北醫學大學,學士班(日間),4779,2038,2741
106,私立,一般大學,1028,臺北醫學大學,學士班(進修),1,0,1
106,私立,一般大學,1028,臺北醫學大學,碩士班(日間),620,225,395
106,私立,一般大學,1028,臺北醫學大學,碩士在職專班,259,63,196
106,私立,一般大學,1028,臺北醫學大學,博士班,453,260,193
106,私立,一般大學,1029,中山醫學大學,學士班(日間),6265,2519,3746
106,私立,一般大學,1029,中山醫學大學,學士班(進修),159,66,93
106,私立,一般大學,1029,中山醫學大學,碩士班(日間),452,157,295
106,私立,一般大學,1029,中山醫學大學,碩士在職專班,148,39,109
106,私立,一般大學,1029,中山醫學大學,博士班,213,142,71
106,私立,技專校院,1030,龍華科技大學,二專(日間),1,0,1
106,私立,技專校院,1030,龍華科技大學,五專,108,87,21
106,私立,技專校院,1030,龍華科技大學,學士班(日間),6497,4178,2319
106,私立,技專校院,1030,龍華科技大學,學士班(進修),3959,2847,1112
106,私立,技專校院,1030,龍華科技大學,碩士班(日間),309,222,87
106,私立,技專校院,1030,龍華科技大學,碩士在職專班,212,152,60
106,私立,技專校院,1031,輔英科技大學,五專,2702,270,2432
106,私立,技專校院,1031,輔英科技大學,學士班(日間),5294,1770,3524
106,私立,技專校院,1031,輔英科技大學,學士班(進修),1133,460,673
106,私立,技專校院,1031,輔英科技大學,碩士班(日間),128,47,81
106,私立,技專校院,1031,輔英科技大學,碩士在職專班,49,2,47
106,私立,技專校院,1032,明新學校財團法人明新科技大學,二專(進修),28,17,11
106,私立,技專校院,1032,明新學校財團法人明新科技大學,學士班(日間),8201,4996,3205
106,私立,技專校院,1032,明新學校財團法人明新科技大學,學士班(進修),3505,2101,1404
106,私立,技專校院,1032,明新學校財團法人明新科技大學,碩士班(日間),310,212,98
106,私立,技專校院,1032,明新學校財團法人明新科技大學,碩士在職專班,275,224,51
106,私立,一般大學,1033,長榮大學,學士班(日間),8605,3935,4670
106,私立,一般大學,1033,長榮大學,學士班(進修),505,298,207
106,私立,一般大學,1033,長榮大學,碩士班(日間),407,165,242
106,私立,一般大學,1033,長榮大學,碩士在職專班,125,61,64
106,私立,一般大學,1033,長榮大學,博士班,38,25,13
106,私立,技專校院,1034,弘光科技大學,二專(進修),110,15,95
106,私立,技專校院,1034,弘光科技大學,五專,264,18,246
106,私立,技專校院,1034,弘光科技大學,學士班(日間),8115,2776,5339
106,私立,技專校院,1034,弘光科技大學,學士班(進修),4171,1482,2689
106,私立,技專校院,1034,弘光科技大學,碩士班(日間),191,55,136
106,私立,技專校院,1034,弘光科技大學,碩士在職專班,101,29,72
106,私立,技專校院,1034,弘光科技大學,博士班,7,1,6
106,私立,一般大學,1035,中國醫藥大學,學士班(日間),6395,2901,3494
106,私立,一般大學,1035,中國醫藥大學,學士班(進修),66,11,55
106,私立,一般大學,1035,中國醫藥大學,碩士班(日間),560,214,346
106,私立,一般大學,1035,中國醫藥大學,碩士在職專班,74,29,45
106,私立,一般大學,1035,中國醫藥大學,博士班,373,228,145
106,私立,技專校院,1036,健行學校財團法人健行科技大學,二專(日間),1,1,0
106,私立,技專校院,1036,健行學校財團法人健行科技大學,五專,26,25,1
106,私立,技專校院,1036,健行學校財團法人健行科技大學,學士班(日間),6998,4519,2479
106,私立,技專校院,1036,健行學校財團法人健行科技大學,學士班(進修),3419,2181,1238
106,私立,技專校院,1036,健行學校財團法人健行科技大學,碩士班(日間),279,199,80
106,私立,技專校院,1036,健行學校財團法人健行科技大學,碩士在職專班,42,32,10
106,私立,技專校院,1037,正修學校財團法人正修科技大學,二專(進修),225,176,49
106,私立,技專校院,1037,正修學校財團法人正修科技大學,學士班(日間),9223,5281,3942
106,私立,技專校院,1037,正修學校財團法人正修科技大學,學士班(進修),6886,4085,2801
106,私立,技專校院,1037,正修學校財團法人正修科技大學,碩士班(日間),385,229,156
106,私立,技專校院,1037,正修學校財團法人正修科技大學,碩士在職專班,172,108,64
106,私立,技專校院,1037,正修學校財團法人正修科技大學,博士班,12,12,0
106,私立,技專校院,1038,萬能學校財團法人萬能科技大學,學士班(日間),6136,3218,2918
106,私立,技專校院,1038,萬能學校財團法人萬能科技大學,學士班(進修),4087,2243,1844
106,私立,技專校院,1038,萬能學校財團法人萬能科技大學,碩士班(日間),140,80,60
106,私立,技專校院,1038,萬能學校財團法人萬能科技大學,碩士在職專班,109,63,46
106,私立,一般大學,1039,玄奘大學,學士班(日間),3389,1473,1916
106,私立,一般大學,1039,玄奘大學,學士班(進修),491,223,268
106,私立,一般大學,1039,玄奘大學,碩士班(日間),305,141,164
106,私立,一般大學,1039,玄奘大學,碩士在職專班,175,66,109
106,私立,一般大學,1039,玄奘大學,博士班,7,5,2
106,私立,技專校院,1040,建國科技大學,學士班(日間),5579,3548,2031
106,私立,技專校院,1040,建國科技大學,學士班(進修),2094,1514,580
106,私立,技專校院,1040,建國科技大學,碩士班(日間),166,90,76
106,私立,技專校院,1041,明志科技大學,學士班(日間),3604,2552,1052
106,私立,技專校院,1041,明志科技大學,學士班(進修),489,363,126
106,私立,技專校院,1041,明志科技大學,碩士班(日間),432,319,113
106,私立,技專校院,1041,明志科技大學,碩士在職專班,31,29,2
106,私立,技專校院,1041,明志科技大學,博士班,5,4,1
106,私立,技專校院,1042,高苑科技大學,學士班(日間),3834,2739,1095
106,私立,技專校院,1042,高苑科技大學,學士班(進修),1407,1014,393
106,私立,技專校院,1042,高苑科技大學,碩士班(日間),126,89,37
106,私立,技專校院,1042,高苑科技大學,碩士在職專班,220,158,62
106,私立,技專校院,1043,大仁科技大學,學士班(日間),4587,2167,2420
106,私立,技專校院,1043,大仁科技大學,學士班(進修),1808,680,1128
106,私立,技專校院,1043,大仁科技大學,碩士班(日間),67,38,29
106,私立,技專校院,1043,大仁科技大學,碩士在職專班,153,85,68
106,私立,技專校院,1044,聖約翰科技大學,五專,278,212,66
106,私立,技專校院,1044,聖約翰科技大學,學士班(日間),3348,2283,1065
106,私立,技專校院,1044,聖約翰科技大學,學士班(進修),138,77,61
106,私立,技專校院,1044,聖約翰科技大學,碩士班(日間),134,116,18
106,私立,技專校院,1044,聖約翰科技大學,碩士在職專班,69,47,22
106,私立,技專校院,1045,嶺東科技大學,學士班(日間),7335,2794,4541
106,私立,技專校院,1045,嶺東科技大學,學士班(進修),2622,1361,1261
106,私立,技專校院,1045,嶺東科技大學,碩士班(日間),232,108,124
106,私立,技專校院,1045,嶺東科技大學,碩士在職專班,123,84,39
106,私立,技專校院,1046,中國科技大學,學士班(日間),8710,3697,5013
106,私立,技專校院,1046,中國科技大學,學士班(進修),2057,1104,953
106,私立,技專校院,1046,中國科技大學,碩士班(日間),156,89,67
106,私立,技專校院,1046,中國科技大學,碩士在職專班,46,32,14
106,私立,技專校院,1047,中臺科技大學,學士班(日間),5860,2234,3626
106,私立,技專校院,1047,中臺科技大學,學士班(進修),2746,771,1975
106,私立,技專校院,1047,中臺科技大學,碩士班(日間),138,48,90
106,私立,技專校院,1047,中臺科技大學,碩士在職專班,243,41,202
106,私立,技專校院,1047,中臺科技大學,博士班,20,18,2
106,私立,一般大學,1048,亞洲大學,學士班(日間),9893,3778,6115
106,私立,一般大學,1048,亞洲大學,學士班(進修),1051,497,554
106,私立,一般大學,1048,亞洲大學,碩士班(日間),600,264,336
106,私立,一般大學,1048,亞洲大學,碩士在職專班,397,225,172
106,私立,一般大學,1048,亞洲大學,博士班,182,114,68
106,私立,一般大學,1049,開南大學,學士班(日間),5627,2761,2866
106,私立,一般大學,1049,開南大學,學士班(進修),1139,626,513
106,私立,一般大學,1049,開南大學,碩士班(日間),221,121,100
106,私立,一般大學,1049,開南大學,碩士在職專班,343,225,118
106,私立,一般大學,1050,佛光大學,學士班(日間),3050,1447,1603
106,私立,一般大學,1050,佛光大學,碩士班(日間),529,220,309
106,私立,一般大學,1050,佛光大學,碩士在職專班,187,109,78
106,私立,一般大學,1050,佛光大學,博士班,56,25,31
106,私立,技專校院,1051,台南家專學校財團法人台南應用科技大學,五專,1181,237,944
106,私立,技專校院,1051,台南家專學校財團法人台南應用科技大學,學士班(日間),8784,2471,6313
106,私立,技專校院,1051,台南家專學校財團法人台南應用科技大學,學士班(進修),2530,843,1687
106,私立,技專校院,1051,台南家專學校財團法人台南應用科技大學,碩士班(日間),118,27,91
106,私立,技專校院,1051,台南家專學校財團法人台南應用科技大學,碩士在職專班,120,28,92
106,私立,技專校院,1052,遠東科技大學,二專(進修),40,38,2
106,私立,技專校院,1052,遠東科技大學,學士班(日間),5304,3386,1918
106,私立,技專校院,1052,遠東科技大學,學士班(進修),664,465,199
106,私立,技專校院,1052,遠東科技大學,碩士班(日間),210,146,64
106,私立,技專校院,1052,遠東科技大學,碩士在職專班,29,28,1
106,私立,技專校院,1053,光宇學校財團法人元培醫事科技大學,學士班(日間),4878,2243,2635
106,私立,技專校院,1053,光宇學校財團法人元培醫事科技大學,學士班(進修),1310,561,749
106,私立,技專校院,1053,光宇學校財團法人元培醫事科技大學,碩士班(日間),217,101,116
106,私立,技專校院,1053,光宇學校財團法人元培醫事科技大學,碩士在職專班,32,12,20
106,私立,技專校院,1054,景文科技大學,學士班(日間),5328,2379,2949
106,私立,技專校院,1054,景文科技大學,學士班(進修),1813,861,952
106,私立,技專校院,1054,景文科技大學,碩士班(日間),61,41,20
106,私立,技專校院,1054,景文科技大學,碩士在職專班,97,61,36
106,私立,技專校院,1055,中華醫事科技大學,二專(日間),110,62,48
106,私立,技專校院,1055,中華醫事科技大學,五專,2669,573,2096
106,私立,技專校院,1055,中華醫事科技大學,學士班(日間),4777,1944,2833
106,私立,技專校院,1055,中華醫事科技大學,學士班(進修),1554,528,1026
106,私立,技專校院,1055,中華醫事科技大學,碩士班(日間),112,58,54
106,私立,技專校院,1055,中華醫事科技大學,碩士在職專班,18,9,9
106,私立,技專校院,1056,東南科技大學,學士班(日間),5580,3705,1875
106,私立,技專校院,1056,東南科技大學,學士班(進修),448,353,95
106,私立,技專校院,1056,東南科技大學,碩士班(日間),155,126,29
106,私立,技專校院,1056,東南科技大學,碩士在職專班,58,48,10
106,私立,技專校院,1057,德明財經科技大學,學士班(日間),7218,2769,4449
106,私立,技專校院,1057,德明財經科技大學,學士班(進修),1086,524,562
106,私立,技專校院,1057,德明財經科技大學,碩士班(日間),54,35,19
106,私立,技專校院,1057,德明財經科技大學,碩士在職專班,62,35,27
106,私立,一般大學,1058,明道學校財團法人明道大學,學士班(日間),3214,1824,1390
106,私立,一般大學,1058,明道學校財團法人明道大學,學士班(進修),955,608,347
106,私立,一般大學,1058,明道學校財團法人明道大學,碩士班(日間),206,106,100
106,私立,一般大學,1058,明道學校財團法人明道大學,碩士在職專班,74,25,49
106,私立,一般大學,1058,明道學校財團法人明道大學,博士班,20,11,9
106,私立,技專校院,1060,南開科技大學,五專,906,730,176
106,私立,技專校院,1060,南開科技大學,學士班(日間),3233,2154,1079
106,私立,技專校院,1060,南開科技大學,學士班(進修),865,552,313
106,私立,技專校院,1060,南開科技大學,碩士班(日間),109,74,35
106,私立,技專校院,1060,南開科技大學,碩士在職專班,104,41,63
106,私立,技專校院,1061,中華學校財團法人中華科技大學,二專(進修),15,2,13
106,私立,技專校院,1061,中華學校財團法人中華科技大學,學士班(日間),5059,3332,1727
106,私立,技專校院,1061,中華學校財團法人中華科技大學,學士班(進修),1136,839,297
106,私立,技專校院,1061,中華學校財團法人中華科技大學,碩士班(日間),228,170,58
106,私立,技專校院,1061,中華學校財團法人中華科技大學,碩士在職專班,100,76,24
106,私立,技專校院,1062,僑光科技大學,二專(進修),17,9,8
106,私立,技專校院,1062,僑光科技大學,五專,1,1,0
106,私立,技專校院,1062,僑光科技大學,學士班(日間),6549,2569,3980
106,私立,技專校院,1062,僑光科技大學,學士班(進修),4206,2218,1988
106,私立,技專校院,1062,僑光科技大學,碩士班(日間),50,24,26
106,私立,技專校院,1062,僑光科技大學,碩士在職專班,33,24,9
106,私立,技專校院,1063,廣亞學校財團法人育達科技大學,學士班(日間),2678,1279,1399
106,私立,技專校院,1063,廣亞學校財團法人育達科技大學,學士班(進修),1597,808,789
106,私立,技專校院,1063,廣亞學校財團法人育達科技大學,碩士班(日間),127,71,56
106,私立,技專校院,1063,廣亞學校財團法人育達科技大學,碩士在職專班,180,102,78
106,私立,技專校院,1064,美和學校財團法人美和科技大學,二專(進修),24,19,5
106,私立,技專校院,1064,美和學校財團法人美和科技大學,五專,1770,217,1553
106,私立,技專校院,1064,美和學校財團法人美和科技大學,學士班(日間),3658,1478,2180
106,私立,技專校院,1064,美和學校財團法人美和科技大學,學士班(進修),1668,419,1249
106,私立,技專校院,1064,美和學校財團法人美和科技大學,碩士班(日間),134,55,79
106,私立,技專校院,1064,美和學校財團法人美和科技大學,碩士在職專班,212,75,137
106,私立,技專校院,1065,吳鳳科技大學,學士班(日間),3624,2474,1150
106,私立,技專校院,1065,吳鳳科技大學,學士班(進修),954,713,241
106,私立,技專校院,1065,吳鳳科技大學,碩士班(日間),61,37,24
106,私立,技專校院,1065,吳鳳科技大學,碩士在職專班,70,41,29
106,私立,技專校院,1066,環球學校財團法人環球科技大學,二專(進修),242,131,111
106,私立,技專校院,1066,環球學校財團法人環球科技大學,學士班(日間),3555,1692,1863
106,私立,技專校院,1066,環球學校財團法人環球科技大學,學士班(進修),1308,600,708
106,私立,技專校院,1066,環球學校財團法人環球科技大學,碩士班(日間),141,72,69
106,私立,技專校院,1066,環球學校財團法人環球科技大學,碩士在職專班,49,34,15
106,私立,一般大學,1067,台灣首府學校財團法人台灣首府大學,學士班(日間),2172,1123,1049
106,私立,一般大學,1067,台灣首府學校財團法人台灣首府大學,學士班(進修),498,303,195
106,私立,一般大學,1067,台灣首府學校財團法人台灣首府大學,碩士班(日間),60,23,37
106,私立,技專校院,1068,中州學校財團法人中州科技大學,學士班(日間),1964,1152,812
106,私立,技專校院,1068,中州學校財團法人中州科技大學,學士班(進修),1425,728,697
106,私立,技專校院,1068,中州學校財團法人中州科技大學,碩士班(日間),53,39,14
106,私立,技專校院,1068,中州學校財團法人中州科技大學,碩士在職專班,31,26,5
106,私立,技專校院,1069,修平學校財團法人修平科技大學,二專(進修),6,6,0
106,私立,技專校院,1069,修平學校財團法人修平科技大學,學士班(日間),4339,2771,1568
106,私立,技專校院,1069,修平學校財團法人修平科技大學,學士班(進修),806,692,114
106,私立,技專校院,1069,修平學校財團法人修平科技大學,碩士班(日間),48,35,13
106,私立,技專校院,1069,修平學校財團法人修平科技大學,碩士在職專班,12,10,2
106,私立,技專校院,1070,長庚學校財團法人長庚科技大學,五專,557,40,517
106,私立,技專校院,1070,長庚學校財團法人長庚科技大學,學士班(日間),4630,440,4190
106,私立,技專校院,1070,長庚學校財團法人長庚科技大學,學士班(進修),1384,82,1302
106,私立,技專校院,1070,長庚學校財團法人長庚科技大學,碩士班(日間),58,0,58
106,私立,技專校院,1070,長庚學校財團法人長庚科技大學,碩士在職專班,83,1,82
106,私立,技專校院,1071,城市學校財團法人臺北城市科技大學,二專(日間),1,1,0
106,私立,技專校院,1071,城市學校財團法人臺北城市科技大學,二專(進修),50,26,24
106,私立,技專校院,1071,城市學校財團法人臺北城市科技大學,五專,1391,968,423
106,私立,技專校院,1071,城市學校財團法人臺北城市科技大學,學士班(日間),7274,4451,2823
106,私立,技專校院,1071,城市學校財團法人臺北城市科技大學,學士班(進修),857,641,216
106,私立,技專校院,1071,城市學校財團法人臺北城市科技大學,碩士班(日間),104,83,21
106,私立,技專校院,1072,大華學校財團法人大華科技大學,二專(進修),83,60,23
106,私立,技專校院,1072,大華學校財團法人大華科技大學,五專,762,457,305
106,私立,技專校院,1072,大華學校財團法人大華科技大學,學士班(日間),800,511,289
106,私立,技專校院,1072,大華學校財團法人大華科技大學,學士班(進修),1273,946,327
106,私立,技專校院,1072,大華學校財團法人大華科技大學,碩士班(日間),22,22,0
106,私立,技專校院,1073,醒吾學校財團法人醒吾科技大學,五專,1006,365,641
106,私立,技專校院,1073,醒吾學校財團法人醒吾科技大學,學士班(日間),5888,2361,3527
106,私立,技專校院,1073,醒吾學校財團法人醒吾科技大學,學士班(進修),1158,550,608
106,私立,技專校院,1073,醒吾學校財團法人醒吾科技大學,碩士班(日間),60,41,19
106,私立,技專校院,1073,醒吾學校財團法人醒吾科技大學,碩士在職專班,86,55,31
106,私立,技專校院,1074,南榮學校財團法人南榮科技大學,二專(進修),157,106,51
106,私立,技專校院,1074,南榮學校財團法人南榮科技大學,五專,175,128,47
106,私立,技專校院,1074,南榮學校財團法人南榮科技大學,學士班(日間),1145,699,446
106,私立,技專校院,1074,南榮學校財團法人南榮科技大學,學士班(進修),679,433,246
106,私立,技專校院,1074,南榮學校財團法人南榮科技大學,碩士班(日間),31,17,14
106,私立,技專校院,1074,南榮學校財團法人南榮科技大學,碩士在職專班,24,14,10
106,私立,技專校院,1075,文藻學校財團法人文藻外語大學,五專,1672,284,1388
106,私立,技專校院,1075,文藻學校財團法人文藻外語大學,學士班(日間),5502,1205,4297
106,私立,技專校院,1075,文藻學校財團法人文藻外語大學,學士班(進修),2020,600,1420
106,私立,技專校院,1075,文藻學校財團法人文藻外語大學,碩士班(日間),163,43,120
106,私立,技專校院,1075,文藻學校財團法人文藻外語大學,碩士在職專班,62,19,43
106,私立,技專校院,1076,華夏學校財團法人華夏科技大學,二專(進修),227,105,122
106,私立,技專校院,1076,華夏學校財團法人華夏科技大學,五專,595,516,79
106,私立,技專校院,1076,華夏學校財團法人華夏科技大學,學士班(日間),2794,1804,990
106,私立,技專校院,1076,華夏學校財團法人華夏科技大學,學士班(進修),1078,672,406
106,私立,技專校院,1076,華夏學校財團法人華夏科技大學,碩士班(日間),40,38,2
106,私立,技專校院,1076,華夏學校財團法人華夏科技大學,碩士在職專班,65,47,18
106,私立,技專校院,1077,慈濟學校財團法人慈濟科技大學,五專,1249,149,1100
106,私立,技專校院,1077,慈濟學校財團法人慈濟科技大學,學士班(日間),1561,600,961
106,私立,技專校院,1077,慈濟學校財團法人慈濟科技大學,學士班(進修),108,8,100
106,私立,技專校院,1077,慈濟學校財團法人慈濟科技大學,碩士班(日間),29,12,17
106,私立,技專校院,1078,致理學校財團法人致理科技大學,二專(日間),3,1,2
106,私立,技專校院,1078,致理學校財團法人致理科技大學,五專,1619,296,1323
106,私立,技專校院,1078,致理學校財團法人致理科技大學,學士班(日間),6649,2077,4572
106,私立,技專校院,1078,致理學校財團法人致理科技大學,學士班(進修),3261,1135,2126
106,私立,技專校院,1078,致理學校財團法人致理科技大學,碩士班(日間),50,10,40
106,私立,技專校院,1078,致理學校財團法人致理科技大學,碩士在職專班,42,7,35
106,私立,一般大學,1079,康寧學校財團法人康寧大學,二專(日間),19,5,14
106,私立,一般大學,1079,康寧學校財團法人康寧大學,二專(進修),342,76,266
106,私立,一般大學,1079,康寧學校財團法人康寧大學,五專,2889,656,2233
106,私立,一般大學,1079,康寧學校財團法人康寧大學,學士班(日間),926,480,446
106,私立,一般大學,1079,康寧學校財團法人康寧大學,學士班(進修),500,302,198
106,私立,一般大學,1079,康寧學校財團法人康寧大學,碩士班(日間),153,54,99
106,私立,一般大學,1079,康寧學校財團法人康寧大學,碩士在職專班,139,55,84
106,私立,技專校院,1080,宏國學校財團法人宏國德霖科技大學,二專(進修),259,150,109
106,私立,技專校院,1080,宏國學校財團法人宏國德霖科技大學,五專,1489,945,544
106,私立,技專校院,1080,宏國學校財團法人宏國德霖科技大學,學士班(日間),2938,1710,1228
106,私立,技專校院,1080,宏國學校財團法人宏國德霖科技大學,學士班(進修),1882,1159,723
106,私立,技專校院,1081,東方學校財團法人東方設計大學,五專,1432,615,817
106,私立,技專校院,1081,東方學校財團法人東方設計大學,學士班(日間),1415,744,671
106,私立,技專校院,1081,東方學校財團法人東方設計大學,學士班(進修),164,68,96
106,私立,技專校院,1081,東方學校財團法人東方設計大學,碩士班(日間),119,51,68
106,私立,技專校院,1081,東方學校財團法人東方設計大學,碩士在職專班,32,18,14
106,私立,技專校院,1081,東方學校財團法人東方設計大學,博士班,30,16,14
106,私立,技專校院,1082,崇右學校財團法人崇右影藝科技大學,五專,320,139,181
106,私立,技專校院,1082,崇右學校財團法人崇右影藝科技大學,學士班(日間),2283,1046,1237
106,私立,技專校院,1082,崇右學校財團法人崇右影藝科技大學,碩士班(日間),82,41,41
106,私立,技專校院,1083,台北海洋學校財團法人台北海洋科技大學,二專(日間),104,96,8
106,私立,技專校院,1083,台北海洋學校財團法人台北海洋科技大學,二專(進修),94,86,8
106,私立,技專校院,1083,台北海洋學校財團法人台北海洋科技大學,五專,1238,768,470
106,私立,技專校院,1083,台北海洋學校財團法人台北海洋科技大學,學士班(日間),3596,1933,1663
106,私立,技專校院,1083,台北海洋學校財團法人台北海洋科技大學,學士班(進修),212,77,135
106,私立,技專校院,1083,台北海洋學校財團法人台北海洋科技大學,碩士班(日間),86,50,36
106,私立,一般大學,1125,中信學校財團法人中信金融管理學院,學士班(日間),438,206,232
106,私立,一般大學,1125,中信學校財團法人中信金融管理學院,學士班(進修),2,1,1
106,私立,一般大學,1125,中信學校財團法人中信金融管理學院,碩士班(日間),45,20,25
106,私立,技專校院,1148,大漢技術學院,二專(進修),178,91,87
106,私立,技專校院,1148,大漢技術學院,學士班(日間),384,257,127
106,私立,技專校院,1148,大漢技術學院,學士班(進修),658,395,263
106,私立,技專校院,1148,大漢技術學院,碩士班(日間),85,66,19
106,私立,技專校院,1159,和春技術學院,二專(進修),491,346,145
106,私立,技專校院,1159,和春技術學院,五專,308,172,136
106,私立,技專校院,1159,和春技術學院,學士班(日間),743,464,279
106,私立,技專校院,1159,和春技術學院,學士班(進修),892,607,285
106,私立,技專校院,1159,和春技術學院,碩士班(日間),41,35,6
106,私立,技專校院,1166,亞東技術學院,學士班(日間),4347,2976,1371
106,私立,技專校院,1166,亞東技術學院,學士班(進修),102,3,99
106,私立,技專校院,1166,亞東技術學院,碩士班(日間),35,26,9
106,私立,技專校院,1168,南亞科技學校財團法人南亞技術學院,二專(進修),92,77,15
106,私立,技專校院,1168,南亞科技學校財團法人南亞技術學院,五專,296,167,129
106,私立,技專校院,1168,南亞科技學校財團法人南亞技術學院,學士班(日間),2178,1200,978
106,私立,技專校院,1168,南亞科技學校財團法人南亞技術學院,學士班(進修),939,651,288
106,私立,技專校院,1168,南亞科技學校財團法人南亞技術學院,碩士班(日間),37,21,16
106,私立,一般大學,1176,稻江科技暨管理學院,學士班(日間),1371,733,638
106,私立,一般大學,1176,稻江科技暨管理學院,學士班(進修),764,271,493
106,私立,一般大學,1176,稻江科技暨管理學院,碩士班(日間),79,37,42
106,私立,一般大學,1176,稻江科技暨管理學院,碩士在職專班,53,35,18
106,私立,技專校院,1182,蘭陽技術學院,五專,496,289,207
106,私立,技專校院,1182,蘭陽技術學院,學士班(日間),562,317,245
106,私立,技專校院,1183,黎明技術學院,二專(進修),73,12,61
106,私立,技專校院,1183,黎明技術學院,五專,695,598,97
106,私立,技專校院,1183,黎明技術學院,學士班(日間),2985,1536,1449
106,私立,技專校院,1183,黎明技術學院,學士班(進修),823,528,295
106,私立,技專校院,1185,經國管理暨健康學院,五專,1465,376,1089
106,私立,技專校院,1185,經國管理暨健康學院,學士班(日間),1957,688,1269
106,私立,技專校院,1185,經國管理暨健康學院,學士班(進修),380,110,270
106,私立,技專校院,1185,經國管理暨健康學院,碩士班(日間),26,11,15
106,私立,技專校院,1185,經國管理暨健康學院,碩士在職專班,46,12,34
106,私立,技專校院,1188,大同技術學院,二專(進修),18,9,9
106,私立,技專校院,1188,大同技術學院,五專,203,112,91
106,私立,技專校院,1188,大同技術學院,學士班(日間),1323,590,733
106,私立,技專校院,1188,大同技術學院,學士班(進修),568,187,381
106,私立,技專校院,1189,亞太學校財團法人亞太創意技術學院,二專(進修),43,0,43
106,私立,技專校院,1189,亞太學校財團法人亞太創意技術學院,學士班(日間),255,172,83
106,私立,技專校院,1189,亞太學校財團法人亞太創意技術學院,學士班(進修),508,72,436
106,私立,技專校院,1189,亞太學校財團法人亞太創意技術學院,碩士班(日間),88,34,54
106,私立,技專校院,1192,臺灣觀光學院,二專(日間),1,1,0
106,私立,技專校院,1192,臺灣觀光學院,二專(進修),41,9,32
106,私立,技專校院,1192,臺灣觀光學院,五專,202,76,126
106,私立,技專校院,1192,臺灣觀光學院,學士班(日間),508,255,253
106,私立,技專校院,1192,臺灣觀光學院,學士班(進修),127,54,73
106,私立,技專校院,1192,臺灣觀光學院,碩士班(日間),17,9,8
106,私立,一般大學,1195,馬偕學校財團法人馬偕醫學院,學士班(日間),625,254,371
106,私立,一般大學,1195,馬偕學校財團法人馬偕醫學院,碩士班(日間),41,12,29
106,私立,一般大學,1196,法鼓學校財團法人法鼓文理學院,學士班(日間),63,23,40
106,私立,一般大學,1196,法鼓學校財團法人法鼓文理學院,碩士班(日間),188,51,137
106,私立,一般大學,1196,法鼓學校財團法人法鼓文理學院,博士班,16,5,11
106,私立,技專校院,1282,馬偕學校財團法人馬偕醫護管理專科學校,二專(日間),19,7,12
106,私立,技專校院,1282,馬偕學校財團法人馬偕醫護管理專科學校,二專(進修),304,154,150
106,私立,技專校院,1282,馬偕學校財團法人馬偕醫護管理專科學校,五專,4058,471,3587
106,私立,技專校院,1283,仁德醫護管理專科學校,二專(進修),362,184,178
106,私立,技專校院,1283,仁德醫護管理專科學校,五專,6239,1364,4875
106,私立,技專校院,1284,樹人醫護管理專科學校,二專(進修),519,332,187
106,私立,技專校院,1284,樹人醫護管理專科學校,五專,6578,1566,5012
106,私立,技專校院,1285,慈惠醫護管理專科學校,二專(日間),127,54,73
106,私立,技專校院,1285,慈惠醫護管理專科學校,二專(進修),306,115,191
106,私立,技專校院,1285,慈惠醫護管理專科學校,五專,5123,1203,3920
106,私立,技專校院,1286,耕莘健康管理專科學校,二專(進修),88,0,88
106,私立,技專校院,1286,耕莘健康管理專科學校,五專,5129,532,4597
106,私立,技專校院,1287,敏惠醫護管理專科學校,五專,3858,466,3392
106,私立,技專校院,1288,高美醫護管理專科學校,二專(進修),107,52,55
106,私立,技專校院,1288,高美醫護管理專科學校,五專,483,118,365
106,私立,技專校院,1289,育英醫護管理專科學校,五專,1969,175,1794
106,私立,技專校院,1290,崇仁醫護管理專科學校,五專,3503,428,3075
106,私立,技專校院,1291,聖母醫護管理專科學校,五專,3155,715,2440
106,私立,技專校院,1292,新生醫護管理專科學校,二專(進修),87,31,56
106,私立,技專校院,1292,新生醫護管理專科學校,五專,5937,740,5197
106,私立,宗教研修學院,1R02,學校財團法人中華浸信會基督教台灣浸會神學院,碩士班(日間),27,15,12
106,私立,宗教研修學院,1R03,臺北基督學院,學士班(日間),116,52,64
106,私立,宗教研修學院,1R04,財團法人一貫道天皇基金會一貫道天皇學院,學士班(日間),40,16,24
106,私立,宗教研修學院,1R04,財團法人一貫道天皇基金會一貫道天皇學院,碩士班(日間),32,11,21
106,私立,宗教研修學院,1R05,台神學校財團法人台灣神學研究學院,碩士班(日間),54,23,31
106,私立,宗教研修學院,1R06,一貫道崇德學院,碩士班(日間),28,15,13
106,公立,一般大學,3002,臺北市立大學,學士班(日間),5276,2385,2891
106,公立,一般大學,3002,臺北市立大學,碩士班(日間),1193,383,810
106,公立,一般大學,3002,臺北市立大學,碩士在職專班,978,302,676
106,公立,一般大學,3002,臺北市立大學,博士班,228,98,130
107,公立,一般大學,0001,國立政治大學,學士班(日間),9630,3983,5647
107,公立,一般大學,0001,國立政治大學,碩士班(日間),3998,1854,2144
107,公立,一般大學,0001,國立政治大學,碩士在職專班,1750,896,854
107,公立,一般大學,0001,國立政治大學,博士班,965,551,414
107,公立,一般大學,0002,國立清華大學,學士班(日間),8754,4737,4017
107,公立,一般大學,0002,國立清華大學,碩士班(日間),5018,3141,1877
107,公立,一般大學,0002,國立清華大學,碩士在職專班,1221,459,762
107,公立,一般大學,0002,國立清華大學,博士班,1664,1221,443
107,公立,一般大學,0003,國立臺灣大學,學士班(日間),16604,9447,7157
107,公立,一般大學,0003,國立臺灣大學,碩士班(日間),10197,6178,4019
107,公立,一般大學,0003,國立臺灣大學,碩士在職專班,1485,904,581
107,公立,一般大學,0003,國立臺灣大學,博士班,3459,2405,1054
107,公立,一般大學,0004,國立臺灣師範大學,學士班(日間),8079,3583,4496
107,公立,一般大學,0004,國立臺灣師範大學,碩士班(日間),4083,1714,2369
107,公立,一般大學,0004,國立臺灣師範大學,碩士在職專班,2042,596,1446
107,公立,一般大學,0004,國立臺灣師範大學,博士班,1378,685,693
107,公立,一般大學,0005,國立成功大學,學士班(日間),11390,7123,4267
107,公立,一般大學,0005,國立成功大學,碩士班(日間),6720,4244,2476
107,公立,一般大學,0005,國立成功大學,碩士在職專班,1386,873,513
107,公立,一般大學,0005,國立成功大學,博士班,1780,1241,539
107,公立,一般大學,0006,國立中興大學,學士班(日間),8090,4685,3405
107,公立,一般大學,0006,國立中興大學,學士班(進修),946,399,547
107,公立,一般大學,0006,國立中興大學,碩士班(日間),3401,2049,1352
107,公立,一般大學,0006,國立中興大學,碩士在職專班,1506,1006,500
107,公立,一般大學,0006,國立中興大學,博士班,941,662,279
107,公立,一般大學,0007,國立交通大學,學士班(日間),5398,3735,1663
107,公立,一般大學,0007,國立交通大學,碩士班(日間),5611,3843,1768
107,公立,一般大學,0007,國立交通大學,碩士在職專班,1533,1029,504
107,公立,一般大學,0007,國立交通大學,博士班,1729,1380,349
107,公立,一般大學,0008,國立中央大學,學士班(日間),6057,3872,2185
107,公立,一般大學,0008,國立中央大學,碩士班(日間),3509,2349,1160
107,公立,一般大學,0008,國立中央大學,碩士在職專班,1348,883,465
107,公立,一般大學,0008,國立中央大學,博士班,1046,763,283
107,公立,一般大學,0009,國立中山大學,學士班(日間),4726,2953,1773
107,公立,一般大學,0009,國立中山大學,碩士班(日間),2889,1841,1048
107,公立,一般大學,0009,國立中山大學,碩士在職專班,1025,523,502
107,公立,一般大學,0009,國立中山大學,博士班,785,534,251
107,公立,一般大學,0012,國立臺灣海洋大學,學士班(日間),5769,4002,1767
107,公立,一般大學,0012,國立臺灣海洋大學,學士班(進修),617,391,226
107,公立,一般大學,0012,國立臺灣海洋大學,碩士班(日間),1416,911,505
107,公立,一般大學,0012,國立臺灣海洋大學,碩士在職專班,552,334,218
107,公立,一般大學,0012,國立臺灣海洋大學,博士班,301,230,71
107,公立,一般大學,0013,國立中正大學,學士班(日間),6579,3591,2988
107,公立,一般大學,0013,國立中正大學,碩士班(日間),2799,1739,1060
107,公立,一般大學,0013,國立中正大學,碩士在職專班,1350,640,710
107,公立,一般大學,0013,國立中正大學,博士班,600,407,193
107,公立,一般大學,0014,國立高雄師範大學,學士班(日間),3492,1676,1816
107,公立,一般大學,0014,國立高雄師範大學,碩士班(日間),1393,531,862
107,公立,一般大學,0014,國立高雄師範大學,碩士在職專班,1352,477,875
107,公立,一般大學,0014,國立高雄師範大學,博士班,441,216,225
107,公立,一般大學,0015,國立彰化師範大學,學士班(日間),4924,2587,2337
107,公立,一般大學,0015,國立彰化師範大學,碩士班(日間),1525,751,774
107,公立,一般大學,0015,國立彰化師範大學,碩士在職專班,1386,602,784
107,公立,一般大學,0015,國立彰化師範大學,博士班,498,305,193
107,公立,一般大學,0016,國立陽明大學,學士班(日間),2084,1167,917
107,公立,一般大學,0016,國立陽明大學,碩士班(日間),1257,517,740
107,公立,一般大學,0016,國立陽明大學,碩士在職專班,141,44,97
107,公立,一般大學,0016,國立陽明大學,博士班,852,495,357
107,公立,一般大學,0017,國立臺北大學,學士班(日間),5822,2655,3167
107,公立,一般大學,0017,國立臺北大學,學士班(進修),2087,791,1296
107,公立,一般大學,0017,國立臺北大學,碩士班(日間),1330,652,678
107,公立,一般大學,0017,國立臺北大學,碩士在職專班,487,236,251
107,公立,一般大學,0017,國立臺北大學,博士班,197,126,71
107,公立,一般大學,0018,國立嘉義大學,學士班(日間),7674,3928,3746
107,公立,一般大學,0018,國立嘉義大學,學士班(進修),2081,1295,786
107,公立,一般大學,0018,國立嘉義大學,碩士班(日間),1306,619,687
107,公立,一般大學,0018,國立嘉義大學,碩士在職專班,965,396,569
107,公立,一般大學,0018,國立嘉義大學,博士班,193,109,84
107,公立,一般大學,0019,國立高雄大學,學士班(日間),4277,2465,1812
107,公立,一般大學,0019,國立高雄大學,學士班(進修),174,106,68
107,公立,一般大學,0019,國立高雄大學,碩士班(日間),636,404,232
107,公立,一般大學,0019,國立高雄大學,碩士在職專班,454,297,157
107,公立,一般大學,0019,國立高雄大學,博士班,24,21,3
107,公立,一般大學,0020,國立東華大學,學士班(日間),7531,3616,3915
107,公立,一般大學,0020,國立東華大學,碩士班(日間),1501,766,735
107,公立,一般大學,0020,國立東華大學,碩士在職專班,521,226,295
107,公立,一般大學,0020,國立東華大學,博士班,375,231,144
107,公立,一般大學,0021,國立暨南國際大學,學士班(日間),4599,2102,2497
107,公立,一般大學,0021,國立暨南國際大學,碩士班(日間),848,422,426
107,公立,一般大學,0021,國立暨南國際大學,碩士在職專班,429,191,238
107,公立,一般大學,0021,國立暨南國際大學,博士班,324,163,161
107,公立,技專校院,0022,國立臺灣科技大學,學士班(日間),5828,4050,1778
107,公立,技專校院,0022,國立臺灣科技大學,學士班(進修),3,0,3
107,公立,技專校院,0022,國立臺灣科技大學,碩士班(日間),3500,2409,1091
107,公立,技專校院,0022,國立臺灣科技大學,碩士在職專班,798,533,265
107,公立,技專校院,0022,國立臺灣科技大學,博士班,1008,798,210
107,公立,技專校院,0023,國立雲林科技大學,學士班(日間),6579,3872,2707
107,公立,技專校院,0023,國立雲林科技大學,學士班(進修),86,36,50
107,公立,技專校院,0023,國立雲林科技大學,碩士班(日間),1934,1219,715
107,公立,技專校院,0023,國立雲林科技大學,碩士在職專班,714,402,312
107,公立,技專校院,0023,國立雲林科技大學,博士班,419,262,157
107,公立,技專校院,0024,國立屏東科技大學,學士班(日間),7839,4136,3703
107,公立,技專校院,0024,國立屏東科技大學,學士班(進修),1471,799,672
107,公立,技專校院,0024,國立屏東科技大學,碩士班(日間),1160,668,492
107,公立,技專校院,0024,國立屏東科技大學,碩士在職專班,404,284,120
107,公立,技專校院,0024,國立屏東科技大學,博士班,248,165,83
107,公立,技專校院,0025,國立臺北科技大學,五專,32,26,6
107,公立,技專校院,0025,國立臺北科技大學,學士班(日間),6050,4200,1850
107,公立,技專校院,0025,國立臺北科技大學,學士班(進修),1946,1624,322
107,公立,技專校院,0025,國立臺北科技大學,碩士班(日間),2842,2130,712
107,公立,技專校院,0025,國立臺北科技大學,碩士在職專班,1538,1105,433
107,公立,技專校院,0025,國立臺北科技大學,博士班,689,537,152
107,公立,技專校院,0025,國立臺北科技大學,附設進院,22,21,1
107,公立,一般大學,0028,國立臺北藝術大學,七年一貫,72,26,46
107,公立,一般大學,0028,國立臺北藝術大學,學士班(日間),1766,630,1136
107,公立,一般大學,0028,國立臺北藝術大學,碩士班(日間),971,347,624
107,公立,一般大學,0028,國立臺北藝術大學,碩士在職專班,169,52,117
107,公立,一般大學,0028,國立臺北藝術大學,博士班,94,30,64
107,公立,一般大學,0029,國立臺灣藝術大學,學士班(日間),2459,707,1752
107,公立,一般大學,0029,國立臺灣藝術大學,學士班(進修),1982,605,1377
107,公立,一般大學,0029,國立臺灣藝術大學,碩士班(日間),725,286,439
107,公立,一般大學,0029,國立臺灣藝術大學,碩士在職專班,422,167,255
107,公立,一般大學,0029,國立臺灣藝術大學,博士班,126,64,62
107,公立,一般大學,0030,國立臺東大學,學士班(日間),3473,1705,1768
107,公立,一般大學,0030,國立臺東大學,學士班(進修),193,86,107
107,公立,一般大學,0030,國立臺東大學,碩士班(日間),337,129,208
107,公立,一般大學,0030,國立臺東大學,碩士在職專班,536,152,384
107,公立,一般大學,0030,國立臺東大學,博士班,44,17,27
107,公立,一般大學,0031,國立宜蘭大學,學士班(日間),4409,2865,1544
107,公立,一般大學,0031,國立宜蘭大學,學士班(進修),372,252,120
107,公立,一般大學,0031,國立宜蘭大學,碩士班(日間),456,298,158
107,公立,一般大學,0031,國立宜蘭大學,碩士在職專班,222,163,59
107,公立,一般大學,0031,國立宜蘭大學,博士班,11,8,3
107,公立,一般大學,0032,國立聯合大學,學士班(日間),5901,4022,1879
107,公立,一般大學,0032,國立聯合大學,學士班(進修),1244,773,471
107,公立,一般大學,0032,國立聯合大學,碩士班(日間),456,332,124
107,公立,一般大學,0032,國立聯合大學,碩士在職專班,6,2,4
107,公立,一般大學,0032,國立聯合大學,博士班,15,15,0
107,公立,技專校院,0033,國立虎尾科技大學,五專,52,45,7
107,公立,技專校院,0033,國立虎尾科技大學,學士班(日間),7379,5640,1739
107,公立,技專校院,0033,國立虎尾科技大學,學士班(進修),1815,1398,417
107,公立,技專校院,0033,國立虎尾科技大學,碩士班(日間),852,670,182
107,公立,技專校院,0033,國立虎尾科技大學,碩士在職專班,191,136,55
107,公立,技專校院,0033,國立虎尾科技大學,博士班,39,31,8
107,公立,技專校院,0033,國立虎尾科技大學,附設進院,158,105,53
107,公立,一般大學,0035,國立臺南藝術大學,七年一貫,167,58,109
107,公立,一般大學,0035,國立臺南藝術大學,學士班(日間),774,240,534
107,公立,一般大學,0035,國立臺南藝術大學,碩士班(日間),535,185,350
107,公立,一般大學,0035,國立臺南藝術大學,碩士在職專班,51,14,37
107,公立,一般大學,0035,國立臺南藝術大學,博士班,37,20,17
107,公立,一般大學,0036,國立臺南大學,學士班(日間),3885,1820,2065
107,公立,一般大學,0036,國立臺南大學,學士班(進修),90,39,51
107,公立,一般大學,0036,國立臺南大學,碩士班(日間),879,394,485
107,公立,一般大學,0036,國立臺南大學,碩士在職專班,662,218,444
107,公立,一般大學,0036,國立臺南大學,博士班,176,77,99
107,公立,一般大學,0037,國立臺北教育大學,學士班(日間),3408,1174,2234
107,公立,一般大學,0037,國立臺北教育大學,碩士班(日間),1321,445,876
107,公立,一般大學,0037,國立臺北教育大學,碩士在職專班,937,199,738
107,公立,一般大學,0037,國立臺北教育大學,博士班,148,73,75
107,公立,一般大學,0039,國立臺中教育大學,學士班(日間),3275,1171,2104
107,公立,一般大學,0039,國立臺中教育大學,碩士班(日間),822,288,534
107,公立,一般大學,0039,國立臺中教育大學,碩士在職專班,754,189,565
107,公立,一般大學,0039,國立臺中教育大學,博士班,115,55,60
107,公立,技專校院,0042,國立澎湖科技大學,五專,13,11,2
107,公立,技專校院,0042,國立澎湖科技大學,學士班(日間),2616,1541,1075
107,公立,技專校院,0042,國立澎湖科技大學,學士班(進修),284,134,150
107,公立,技專校院,0042,國立澎湖科技大學,碩士班(日間),69,40,29
107,公立,技專校院,0042,國立澎湖科技大學,碩士在職專班,43,23,20
107,公立,技專校院,0043,國立勤益科技大學,學士班(日間),6749,4591,2158
107,公立,技專校院,0043,國立勤益科技大學,學士班(進修),3498,2872,626
107,公立,技專校院,0043,國立勤益科技大學,碩士班(日間),555,429,126
107,公立,技專校院,0043,國立勤益科技大學,碩士在職專班,281,224,57
107,公立,技專校院,0043,國立勤益科技大學,博士班,18,16,2
107,公立,技專校院,0043,國立勤益科技大學,附設進專,429,310,119
107,公立,技專校院,0043,國立勤益科技大學,附設進院,366,285,81
107,公立,一般大學,0044,國立體育大學,學士班(日間),1675,1075,600
107,公立,一般大學,0044,國立體育大學,學士班(進修),73,55,18
107,公立,一般大學,0044,國立體育大學,碩士班(日間),343,189,154
107,公立,一般大學,0044,國立體育大學,碩士在職專班,216,132,84
107,公立,一般大學,0044,國立體育大學,博士班,158,108,50
107,公立,技專校院,0046,國立臺北護理健康大學,學士班(日間),3693,768,2925
107,公立,技專校院,0046,國立臺北護理健康大學,學士班(進修),714,24,690
107,公立,技專校院,0046,國立臺北護理健康大學,碩士班(日間),568,94,474
107,公立,技專校院,0046,國立臺北護理健康大學,碩士在職專班,203,30,173
107,公立,技專校院,0046,國立臺北護理健康大學,博士班,69,6,63
107,公立,技專校院,0047,國立高雄餐旅大學,二專(進修),12,5,7
107,公立,技專校院,0047,國立高雄餐旅大學,五專,244,96,148
107,公立,技專校院,0047,國立高雄餐旅大學,學士班(日間),3268,936,2332
107,公立,技專校院,0047,國立高雄餐旅大學,學士班(進修),1444,411,1033
107,公立,技專校院,0047,國立高雄餐旅大學,碩士班(日間),150,50,100
107,公立,技專校院,0047,國立高雄餐旅大學,碩士在職專班,50,28,22
107,公立,技專校院,0047,國立高雄餐旅大學,博士班,29,12,17
107,公立,一般大學,0048,國立金門大學,學士班(日間),3153,1593,1560
107,公立,一般大學,0048,國立金門大學,學士班(進修),852,487,365
107,公立,一般大學,0048,國立金門大學,碩士班(日間),207,127,80
107,公立,一般大學,0048,國立金門大學,碩士在職專班,91,69,22
107,公立,一般大學,0049,國立臺灣體育運動大學,學士班(日間),2379,1400,979
107,公立,一般大學,0049,國立臺灣體育運動大學,學士班(進修),365,259,106
107,公立,一般大學,0049,國立臺灣體育運動大學,碩士班(日間),251,122,129
107,公立,一般大學,0049,國立臺灣體育運動大學,碩士在職專班,105,61,44
107,公立,技專校院,0050,國立臺中科技大學,二專(進修),12,0,12
107,公立,技專校院,0050,國立臺中科技大學,五專,3484,759,2725
107,公立,技專校院,0050,國立臺中科技大學,學士班(日間),6932,1883,5049
107,公立,技專校院,0050,國立臺中科技大學,學士班(進修),2550,824,1726
107,公立,技專校院,0050,國立臺中科技大學,碩士班(日間),369,166,203
107,公立,技專校院,0050,國立臺中科技大學,碩士在職專班,218,100,118
107,公立,技專校院,0050,國立臺中科技大學,附設進專,1326,492,834
107,公立,技專校院,0050,國立臺中科技大學,附設進院,1321,437,884
107,公立,技專校院,0051,國立臺北商業大學,二專(進修),2,2,0
107,公立,技專校院,0051,國立臺北商業大學,五專,1874,523,1351
107,公立,技專校院,0051,國立臺北商業大學,學士班(日間),3145,859,2286
107,公立,技專校院,0051,國立臺北商業大學,學士班(進修),1427,423,1004
107,公立,技專校院,0051,國立臺北商業大學,碩士班(日間),238,96,142
107,公立,技專校院,0051,國立臺北商業大學,碩士在職專班,43,23,20
107,公立,技專校院,0051,國立臺北商業大學,附設進專,1040,354,686
107,公立,一般大學,0052,國立屏東大學,學士班(日間),6731,2672,4059
107,公立,一般大學,0052,國立屏東大學,學士班(進修),670,320,350
107,公立,一般大學,0052,國立屏東大學,碩士班(日間),889,381,508
107,公立,一般大學,0052,國立屏東大學,碩士在職專班,633,188,445
107,公立,一般大學,0052,國立屏東大學,博士班,46,24,22
107,公立,技專校院,0053,國立高雄科技大學,五專,639,529,110
107,公立,技專校院,0053,國立高雄科技大學,學士班(日間),17789,10873,6916
107,公立,技專校院,0053,國立高雄科技大學,學士班(進修),3740,2500,1240
107,公立,技專校院,0053,國立高雄科技大學,碩士班(日間),2523,1676,847
107,公立,技專校院,0053,國立高雄科技大學,碩士在職專班,2032,1376,656
107,公立,技專校院,0053,國立高雄科技大學,博士班,551,440,111
107,公立,技專校院,0053,國立高雄科技大學,附設進院,736,411,325
107,公立,技專校院,0144,國立臺灣戲曲學院,學士班(日間),568,200,368
107,公立,技專校院,0144,國立臺灣戲曲學院,學士班(進修),39,19,20
107,公立,技專校院,0221,國立臺南護理專科學校,二專(日間),110,2,108
107,公立,技專校院,0221,國立臺南護理專科學校,二專(進修),53,4,49
107,公立,技專校院,0221,國立臺南護理專科學校,五專,1795,129,1666
107,公立,技專校院,0222,國立臺東專科學校,二專(日間),581,438,143
107,公立,技專校院,0222,國立臺東專科學校,二專(進修),89,53,36
107,公立,技專校院,0222,國立臺東專科學校,五專,504,219,285
107,私立,一般大學,1001,東海大學,學士班(日間),13279,5983,7296
107,私立,一般大學,1001,東海大學,學士班(進修),604,323,281
107,私立,一般大學,1001,東海大學,碩士班(日間),1234,625,609
107,私立,一般大學,1001,東海大學,碩士在職專班,720,350,370
107,私立,一般大學,1001,東海大學,博士班,243,147,96
107,私立,一般大學,1002,輔仁大學,學士班(日間),17839,7598,10241
107,私立,一般大學,1002,輔仁大學,學士班(進修),4487,1700,2787
107,私立,一般大學,1002,輔仁大學,碩士班(日間),2007,847,1160
107,私立,一般大學,1002,輔仁大學,碩士在職專班,1423,604,819
107,私立,一般大學,1002,輔仁大學,博士班,420,233,187
107,私立,一般大學,1003,東吳大學,學士班(日間),12039,4766,7273
107,私立,一般大學,1003,東吳大學,學士班(進修),1071,356,715
107,私立,一般大學,1003,東吳大學,碩士班(日間),1256,572,684
107,私立,一般大學,1003,東吳大學,碩士在職專班,1175,539,636
107,私立,一般大學,1003,東吳大學,博士班,124,66,58
107,私立,一般大學,1004,中原大學,學士班(日間),13361,7271,6090
107,私立,一般大學,1004,中原大學,碩士班(日間),1611,973,638
107,私立,一般大學,1004,中原大學,碩士在職專班,869,542,327
107,私立,一般大學,1004,中原大學,博士班,348,243,105
107,私立,一般大學,1005,淡江大學,學士班(日間),20476,10374,10102
107,私立,一般大學,1005,淡江大學,學士班(進修),1661,885,776
107,私立,一般大學,1005,淡江大學,碩士班(日間),1790,1018,772
107,私立,一般大學,1005,淡江大學,碩士在職專班,988,514,474
107,私立,一般大學,1005,淡江大學,博士班,428,283,145
107,私立,一般大學,1006,中國文化大學,學士班(日間),20749,9846,10903
107,私立,一般大學,1006,中國文化大學,學士班(進修),1696,713,983
107,私立,一般大學,1006,中國文化大學,碩士班(日間),1673,895,778
107,私立,一般大學,1006,中國文化大學,碩士在職專班,560,215,345
107,私立,一般大學,1006,中國文化大學,博士班,547,350,197
107,私立,一般大學,1007,逢甲大學,學士班(日間),16832,10363,6469
107,私立,一般大學,1007,逢甲大學,學士班(進修),872,495,377
107,私立,一般大學,1007,逢甲大學,碩士班(日間),1608,1078,530
107,私立,一般大學,1007,逢甲大學,碩士在職專班,1080,661,419
107,私立,一般大學,1007,逢甲大學,博士班,420,315,105
107,私立,一般大學,1008,靜宜大學,學士班(日間),11205,4315,6890
107,私立,一般大學,1008,靜宜大學,碩士班(日間),530,192,338
107,私立,一般大學,1008,靜宜大學,碩士在職專班,323,127,196
107,私立,一般大學,1008,靜宜大學,博士班,46,24,22
107,私立,一般大學,1009,長庚大學,學士班(日間),5260,2652,2608
107,私立,一般大學,1009,長庚大學,碩士班(日間),1096,556,540
107,私立,一般大學,1009,長庚大學,碩士在職專班,199,96,103
107,私立,一般大學,1009,長庚大學,博士班,497,334,163
107,私立,一般大學,1010,元智大學,學士班(日間),7113,4053,3060
107,私立,一般大學,1010,元智大學,碩士班(日間),846,550,296
107,私立,一般大學,1010,元智大學,碩士在職專班,644,420,224
107,私立,一般大學,1010,元智大學,博士班,279,203,76
107,私立,一般大學,1011,中華大學,學士班(日間),5020,3121,1899
107,私立,一般大學,1011,中華大學,學士班(進修),432,280,152
107,私立,一般大學,1011,中華大學,碩士班(日間),516,283,233
107,私立,一般大學,1011,中華大學,碩士在職專班,211,111,100
107,私立,一般大學,1011,中華大學,博士班,88,62,26
107,私立,一般大學,1012,大葉大學,學士班(日間),8019,4191,3828
107,私立,一般大學,1012,大葉大學,學士班(進修),1104,588,516
107,私立,一般大學,1012,大葉大學,碩士班(日間),670,369,301
107,私立,一般大學,1012,大葉大學,碩士在職專班,384,172,212
107,私立,一般大學,1012,大葉大學,博士班,134,102,32
107,私立,一般大學,1013,華梵大學,學士班(日間),1447,788,659
107,私立,一般大學,1013,華梵大學,碩士班(日間),213,114,99
107,私立,一般大學,1013,華梵大學,碩士在職專班,150,44,106
107,私立,一般大學,1013,華梵大學,博士班,61,39,22
107,私立,一般大學,1014,義守大學,學士班(日間),12546,6278,6268
107,私立,一般大學,1014,義守大學,學士班(進修),1964,1257,707
107,私立,一般大學,1014,義守大學,碩士班(日間),402,249,153
107,私立,一般大學,1014,義守大學,碩士在職專班,473,339,134
107,私立,一般大學,1014,義守大學,博士班,147,113,34
107,私立,一般大學,1015,世新大學,學士班(日間),9671,3409,6262
107,私立,一般大學,1015,世新大學,學士班(進修),425,163,262
107,私立,一般大學,1015,世新大學,碩士班(日間),612,294,318
107,私立,一般大學,1015,世新大學,碩士在職專班,785,422,363
107,私立,一般大學,1015,世新大學,博士班,97,45,52
107,私立,一般大學,1016,銘傳大學,學士班(日間),17333,6868,10465
107,私立,一般大學,1016,銘傳大學,碩士班(日間),741,330,411
107,私立,一般大學,1016,銘傳大學,碩士在職專班,828,382,446
107,私立,一般大學,1016,銘傳大學,博士班,73,30,43
107,私立,一般大學,1017,實踐大學,學士班(日間),11258,3713,7545
107,私立,一般大學,1017,實踐大學,學士班(進修),2161,664,1497
107,私立,一般大學,1017,實踐大學,碩士班(日間),380,161,219
107,私立,一般大學,1017,實踐大學,碩士在職專班,144,56,88
107,私立,一般大學,1017,實踐大學,博士班,25,10,15
107,私立,技專校院,1018,朝陽科技大學,學士班(日間),11461,4783,6678
107,私立,技專校院,1018,朝陽科技大學,學士班(進修),3014,1573,1441
107,私立,技專校院,1018,朝陽科技大學,碩士班(日間),642,349,293
107,私立,技專校院,1018,朝陽科技大學,碩士在職專班,404,212,192
107,私立,技專校院,1018,朝陽科技大學,博士班,91,69,22
107,私立,一般大學,1019,高雄醫學大學,學士班(日間),5546,2445,3101
107,私立,一般大學,1019,高雄醫學大學,學士班(進修),40,0,40
107,私立,一般大學,1019,高雄醫學大學,碩士班(日間),681,231,450
107,私立,一般大學,1019,高雄醫學大學,碩士在職專班,230,85,145
107,私立,一般大學,1019,高雄醫學大學,博士班,305,161,144
107,私立,一般大學,1020,南華大學,學士班(日間),4489,2160,2329
107,私立,一般大學,1020,南華大學,學士班(進修),325,186,139
107,私立,一般大學,1020,南華大學,碩士班(日間),644,271,373
107,私立,一般大學,1020,南華大學,碩士在職專班,392,159,233
107,私立,一般大學,1020,南華大學,博士班,48,27,21
107,私立,一般大學,1021,真理大學,學士班(日間),5830,2834,2996
107,私立,一般大學,1021,真理大學,學士班(進修),218,123,95
107,私立,一般大學,1021,真理大學,碩士班(日間),135,84,51
107,私立,一般大學,1021,真理大學,碩士在職專班,21,10,11
107,私立,一般大學,1022,大同大學,學士班(日間),3689,2226,1463
107,私立,一般大學,1022,大同大學,碩士班(日間),353,264,89
107,私立,一般大學,1022,大同大學,碩士在職專班,232,178,54
107,私立,一般大學,1022,大同大學,博士班,116,66,50
107,私立,技專校院,1023,南臺學校財團法人南臺科技大學,五專,66,61,5
107,私立,技專校院,1023,南臺學校財團法人南臺科技大學,學士班(日間),12892,7178,5714
107,私立,技專校院,1023,南臺學校財團法人南臺科技大學,學士班(進修),4345,2665,1680
107,私立,技專校院,1023,南臺學校財團法人南臺科技大學,碩士班(日間),830,474,356
107,私立,技專校院,1023,南臺學校財團法人南臺科技大學,碩士在職專班,390,192,198
107,私立,技專校院,1023,南臺學校財團法人南臺科技大學,博士班,99,83,16
107,私立,技專校院,1024,崑山科技大學,學士班(日間),7795,4613,3182
107,私立,技專校院,1024,崑山科技大學,學士班(進修),3323,2245,1078
107,私立,技專校院,1024,崑山科技大學,碩士班(日間),353,230,123
107,私立,技專校院,1024,崑山科技大學,碩士在職專班,170,121,49
107,私立,技專校院,1024,崑山科技大學,博士班,36,27,9
107,私立,技專校院,1024,崑山科技大學,附設進專,117,62,55
107,私立,技專校院,1025,嘉藥學校財團法人嘉南藥理大學,學士班(日間),11115,4622,6493
107,私立,技專校院,1025,嘉藥學校財團法人嘉南藥理大學,學士班(進修),2787,1260,1527
107,私立,技專校院,1025,嘉藥學校財團法人嘉南藥理大學,碩士班(日間),207,94,113
107,私立,技專校院,1025,嘉藥學校財團法人嘉南藥理大學,碩士在職專班,238,99,139
107,私立,技專校院,1025,嘉藥學校財團法人嘉南藥理大學,附設進院,1,1,0
107,私立,技專校院,1026,樹德科技大學,學士班(日間),7881,3332,4549
107,私立,技專校院,1026,樹德科技大學,學士班(進修),2023,977,1046
107,私立,技專校院,1026,樹德科技大學,碩士班(日間),249,130,119
107,私立,技專校院,1026,樹德科技大學,碩士在職專班,438,190,248
107,私立,技專校院,1026,樹德科技大學,博士班,35,17,18
107,私立,技專校院,1026,樹德科技大學,附設進專,497,195,302
107,私立,一般大學,1027,慈濟學校財團法人慈濟大學,學士班(日間),2968,1148,1820
107,私立,一般大學,1027,慈濟學校財團法人慈濟大學,碩士班(日間),336,121,215
107,私立,一般大學,1027,慈濟學校財團法人慈濟大學,碩士在職專班,43,7,36
107,私立,一般大學,1027,慈濟學校財團法人慈濟大學,博士班,101,53,48
107,私立,一般大學,1028,臺北醫學大學,學士班(日間),4762,2000,2762
107,私立,一般大學,1028,臺北醫學大學,學士班(進修),1,0,1
107,私立,一般大學,1028,臺北醫學大學,碩士班(日間),621,222,399
107,私立,一般大學,1028,臺北醫學大學,碩士在職專班,267,65,202
107,私立,一般大學,1028,臺北醫學大學,博士班,489,275,214
107,私立,一般大學,1029,中山醫學大學,學士班(日間),6099,2355,3744
107,私立,一般大學,1029,中山醫學大學,學士班(進修),120,42,78
107,私立,一般大學,1029,中山醫學大學,碩士班(日間),476,142,334
107,私立,一般大學,1029,中山醫學大學,碩士在職專班,194,47,147
107,私立,一般大學,1029,中山醫學大學,博士班,207,138,69
107,私立,技專校院,1030,龍華科技大學,五專,246,209,37
107,私立,技專校院,1030,龍華科技大學,學士班(日間),6787,4403,2384
107,私立,技專校院,1030,龍華科技大學,學士班(進修),3738,2773,965
107,私立,技專校院,1030,龍華科技大學,碩士班(日間),288,208,80
107,私立,技專校院,1030,龍華科技大學,碩士在職專班,170,109,61
107,私立,技專校院,1031,輔英科技大學,五專,2693,284,2409
107,私立,技專校院,1031,輔英科技大學,學士班(日間),5249,1715,3534
107,私立,技專校院,1031,輔英科技大學,學士班(進修),1216,515,701
107,私立,技專校院,1031,輔英科技大學,碩士班(日間),132,43,89
107,私立,技專校院,1031,輔英科技大學,碩士在職專班,111,10,101
107,私立,技專校院,1032,明新學校財團法人明新科技大學,二專(日間),8,7,1
107,私立,技專校院,1032,明新學校財團法人明新科技大學,二專(進修),43,23,20
107,私立,技專校院,1032,明新學校財團法人明新科技大學,學士班(日間),8340,5152,3188
107,私立,技專校院,1032,明新學校財團法人明新科技大學,學士班(進修),3404,2099,1305
107,私立,技專校院,1032,明新學校財團法人明新科技大學,碩士班(日間),267,179,88
107,私立,技專校院,1032,明新學校財團法人明新科技大學,碩士在職專班,330,257,73
107,私立,技專校院,1032,明新學校財團法人明新科技大學,附設進專,154,89,65
107,私立,技專校院,1032,明新學校財團法人明新科技大學,附設進院,240,119,121
107,私立,一般大學,1033,長榮大學,學士班(日間),8210,3594,4616
107,私立,一般大學,1033,長榮大學,學士班(進修),539,314,225
107,私立,一般大學,1033,長榮大學,碩士班(日間),379,149,230
107,私立,一般大學,1033,長榮大學,碩士在職專班,94,39,55
107,私立,一般大學,1033,長榮大學,博士班,37,26,11
107,私立,技專校院,1034,弘光科技大學,二專(進修),160,28,132
107,私立,技專校院,1034,弘光科技大學,五專,265,23,242
107,私立,技專校院,1034,弘光科技大學,學士班(日間),8067,2752,5315
107,私立,技專校院,1034,弘光科技大學,學士班(進修),4177,1508,2669
107,私立,技專校院,1034,弘光科技大學,碩士班(日間),194,55,139
107,私立,技專校院,1034,弘光科技大學,碩士在職專班,98,24,74
107,私立,技專校院,1034,弘光科技大學,博士班,10,1,9
107,私立,一般大學,1035,中國醫藥大學,學士班(日間),6420,2866,3554
107,私立,一般大學,1035,中國醫藥大學,學士班(進修),38,5,33
107,私立,一般大學,1035,中國醫藥大學,碩士班(日間),508,203,305
107,私立,一般大學,1035,中國醫藥大學,碩士在職專班,74,27,47
107,私立,一般大學,1035,中國醫藥大學,博士班,385,227,158
107,私立,技專校院,1036,健行學校財團法人健行科技大學,五專,26,25,1
107,私立,技專校院,1036,健行學校財團法人健行科技大學,學士班(日間),7228,4703,2525
107,私立,技專校院,1036,健行學校財團法人健行科技大學,學士班(進修),3728,2399,1329
107,私立,技專校院,1036,健行學校財團法人健行科技大學,碩士班(日間),296,207,89
107,私立,技專校院,1036,健行學校財團法人健行科技大學,碩士在職專班,55,34,21
107,私立,技專校院,1037,正修學校財團法人正修科技大學,二專(進修),314,239,75
107,私立,技專校院,1037,正修學校財團法人正修科技大學,五專,66,51,15
107,私立,技專校院,1037,正修學校財團法人正修科技大學,學士班(日間),8959,5200,3759
107,私立,技專校院,1037,正修學校財團法人正修科技大學,學士班(進修),7029,4246,2783
107,私立,技專校院,1037,正修學校財團法人正修科技大學,碩士班(日間),349,204,145
107,私立,技專校院,1037,正修學校財團法人正修科技大學,碩士在職專班,210,131,79
107,私立,技專校院,1037,正修學校財團法人正修科技大學,博士班,12,12,0
107,私立,技專校院,1037,正修學校財團法人正修科技大學,附設進專,1333,727,606
107,私立,技專校院,1038,萬能學校財團法人萬能科技大學,學士班(日間),6270,3360,2910
107,私立,技專校院,1038,萬能學校財團法人萬能科技大學,學士班(進修),3845,2100,1745
107,私立,技專校院,1038,萬能學校財團法人萬能科技大學,碩士班(日間),144,72,72
107,私立,技專校院,1038,萬能學校財團法人萬能科技大學,碩士在職專班,121,49,72
107,私立,技專校院,1038,萬能學校財團法人萬能科技大學,附設進專,146,37,109
107,私立,一般大學,1039,玄奘大學,學士班(日間),2859,1186,1673
107,私立,一般大學,1039,玄奘大學,學士班(進修),348,141,207
107,私立,一般大學,1039,玄奘大學,碩士班(日間),290,116,174
107,私立,一般大學,1039,玄奘大學,碩士在職專班,172,62,110
107,私立,一般大學,1039,玄奘大學,博士班,5,3,2
107,私立,技專校院,1040,建國科技大學,學士班(日間),5205,3379,1826
107,私立,技專校院,1040,建國科技大學,學士班(進修),2172,1597,575
107,私立,技專校院,1040,建國科技大學,碩士班(日間),168,94,74
107,私立,技專校院,1040,建國科技大學,附設進專,264,171,93
107,私立,技專校院,1040,建國科技大學,附設進院,112,77,35
107,私立,技專校院,1041,明志科技大學,學士班(日間),3587,2580,1007
107,私立,技專校院,1041,明志科技大學,學士班(進修),484,394,90
107,私立,技專校院,1041,明志科技大學,碩士班(日間),439,314,125
107,私立,技專校院,1041,明志科技大學,碩士在職專班,35,27,8
107,私立,技專校院,1041,明志科技大學,博士班,14,12,2
107,私立,技專校院,1042,高苑科技大學,學士班(日間),3067,2257,810
107,私立,技專校院,1042,高苑科技大學,學士班(進修),1347,986,361
107,私立,技專校院,1042,高苑科技大學,碩士班(日間),98,74,24
107,私立,技專校院,1042,高苑科技大學,碩士在職專班,180,124,56
107,私立,技專校院,1042,高苑科技大學,附設進專,228,136,92
107,私立,技專校院,1042,高苑科技大學,附設進院,327,204,123
107,私立,技專校院,1043,大仁科技大學,學士班(日間),4238,2000,2238
107,私立,技專校院,1043,大仁科技大學,學士班(進修),1826,688,1138
107,私立,技專校院,1043,大仁科技大學,碩士班(日間),66,36,30
107,私立,技專校院,1043,大仁科技大學,碩士在職專班,130,60,70
107,私立,技專校院,1043,大仁科技大學,附設進專,144,70,74
107,私立,技專校院,1044,聖約翰科技大學,五專,327,246,81
107,私立,技專校院,1044,聖約翰科技大學,學士班(日間),2980,2038,942
107,私立,技專校院,1044,聖約翰科技大學,學士班(進修),285,203,82
107,私立,技專校院,1044,聖約翰科技大學,碩士班(日間),139,116,23
107,私立,技專校院,1044,聖約翰科技大學,碩士在職專班,76,57,19
107,私立,技專校院,1045,嶺東科技大學,學士班(日間),7280,2797,4483
107,私立,技專校院,1045,嶺東科技大學,學士班(進修),2679,1386,1293
107,私立,技專校院,1045,嶺東科技大學,碩士班(日間),231,108,123
107,私立,技專校院,1045,嶺東科技大學,碩士在職專班,146,98,48
107,私立,技專校院,1045,嶺東科技大學,附設進專,12,7,5
107,私立,技專校院,1046,中國科技大學,二專(進修),24,23,1
107,私立,技專校院,1046,中國科技大學,學士班(日間),7977,3490,4487
107,私立,技專校院,1046,中國科技大學,學士班(進修),1739,948,791
107,私立,技專校院,1046,中國科技大學,碩士班(日間),156,92,64
107,私立,技專校院,1046,中國科技大學,碩士在職專班,76,58,18
107,私立,技專校院,1046,中國科技大學,附設進專,586,298,288
107,私立,技專校院,1046,中國科技大學,附設進院,612,308,304
107,私立,技專校院,1047,中臺科技大學,二專(日間),27,13,14
107,私立,技專校院,1047,中臺科技大學,學士班(日間),5610,2155,3455
107,私立,技專校院,1047,中臺科技大學,學士班(進修),2617,711,1906
107,私立,技專校院,1047,中臺科技大學,碩士班(日間),110,35,75
107,私立,技專校院,1047,中臺科技大學,碩士在職專班,304,62,242
107,私立,技專校院,1047,中臺科技大學,博士班,17,14,3
107,私立,一般大學,1048,亞洲大學,學士班(日間),9616,3524,6092
107,私立,一般大學,1048,亞洲大學,學士班(進修),970,446,524
107,私立,一般大學,1048,亞洲大學,碩士班(日間),581,252,329
107,私立,一般大學,1048,亞洲大學,碩士在職專班,401,190,211
107,私立,一般大學,1048,亞洲大學,博士班,211,132,79
107,私立,一般大學,1049,開南大學,學士班(日間),5119,2508,2611
107,私立,一般大學,1049,開南大學,學士班(進修),991,581,410
107,私立,一般大學,1049,開南大學,碩士班(日間),240,122,118
107,私立,一般大學,1049,開南大學,碩士在職專班,315,183,132
107,私立,一般大學,1050,佛光大學,學士班(日間),2970,1380,1590
107,私立,一般大學,1050,佛光大學,碩士班(日間),492,213,279
107,私立,一般大學,1050,佛光大學,碩士在職專班,175,90,85
107,私立,一般大學,1050,佛光大學,博士班,59,24,35
107,私立,技專校院,1051,台南家專學校財團法人台南應用科技大學,五專,1115,227,888
107,私立,技專校院,1051,台南家專學校財團法人台南應用科技大學,學士班(日間),8613,2454,6159
107,私立,技專校院,1051,台南家專學校財團法人台南應用科技大學,學士班(進修),2781,946,1835
107,私立,技專校院,1051,台南家專學校財團法人台南應用科技大學,碩士班(日間),113,28,85
107,私立,技專校院,1051,台南家專學校財團法人台南應用科技大學,碩士在職專班,109,37,72
107,私立,技專校院,1052,遠東科技大學,二專(進修),37,35,2
107,私立,技專校院,1052,遠東科技大學,學士班(日間),4552,2920,1632
107,私立,技專校院,1052,遠東科技大學,學士班(進修),714,509,205
107,私立,技專校院,1052,遠東科技大學,碩士班(日間),217,120,97
107,私立,技專校院,1052,遠東科技大學,碩士在職專班,33,31,2
107,私立,技專校院,1052,遠東科技大學,附設進專,175,92,83
107,私立,技專校院,1052,遠東科技大學,附設進院,210,124,86
107,私立,技專校院,1053,光宇學校財團法人元培醫事科技大學,二專(日間),39,31,8
107,私立,技專校院,1053,光宇學校財團法人元培醫事科技大學,學士班(日間),4453,1979,2474
107,私立,技專校院,1053,光宇學校財團法人元培醫事科技大學,學士班(進修),1533,643,890
107,私立,技專校院,1053,光宇學校財團法人元培醫事科技大學,碩士班(日間),225,109,116
107,私立,技專校院,1053,光宇學校財團法人元培醫事科技大學,碩士在職專班,42,14,28
107,私立,技專校院,1053,光宇學校財團法人元培醫事科技大學,附設進專,105,68,37
107,私立,技專校院,1054,景文科技大學,學士班(日間),5181,2351,2830
107,私立,技專校院,1054,景文科技大學,學士班(進修),1760,844,916
107,私立,技專校院,1054,景文科技大學,碩士班(日間),53,38,15
107,私立,技專校院,1054,景文科技大學,碩士在職專班,67,47,20
107,私立,技專校院,1054,景文科技大學,附設進專,222,129,93
107,私立,技專校院,1055,中華醫事科技大學,二專(日間),85,56,29
107,私立,技專校院,1055,中華醫事科技大學,五專,2877,612,2265
107,私立,技專校院,1055,中華醫事科技大學,學士班(日間),4643,1888,2755
107,私立,技專校院,1055,中華醫事科技大學,學士班(進修),1442,500,942
107,私立,技專校院,1055,中華醫事科技大學,碩士班(日間),95,46,49
107,私立,技專校院,1055,中華醫事科技大學,碩士在職專班,20,13,7
107,私立,技專校院,1056,東南科技大學,學士班(日間),5209,3459,1750
107,私立,技專校院,1056,東南科技大學,學士班(進修),538,434,104
107,私立,技專校院,1056,東南科技大學,碩士班(日間),133,98,35
107,私立,技專校院,1056,東南科技大學,碩士在職專班,55,47,8
107,私立,技專校院,1056,東南科技大學,附設進專,3,3,0
107,私立,技專校院,1057,德明財經科技大學,學士班(日間),7233,2878,4355
107,私立,技專校院,1057,德明財經科技大學,學士班(進修),841,412,429
107,私立,技專校院,1057,德明財經科技大學,碩士班(日間),57,31,26
107,私立,技專校院,1057,德明財經科技大學,碩士在職專班,55,32,23
107,私立,技專校院,1057,德明財經科技大學,附設進專,19,7,12
107,私立,技專校院,1057,德明財經科技大學,附設進院,84,29,55
107,私立,一般大學,1058,明道學校財團法人明道大學,學士班(日間),2819,1608,1211
107,私立,一般大學,1058,明道學校財團法人明道大學,學士班(進修),806,514,292
107,私立,一般大學,1058,明道學校財團法人明道大學,碩士班(日間),182,98,84
107,私立,一般大學,1058,明道學校財團法人明道大學,碩士在職專班,80,28,52
107,私立,一般大學,1058,明道學校財團法人明道大學,博士班,26,14,12
107,私立,技專校院,1060,南開科技大學,五專,813,662,151
107,私立,技專校院,1060,南開科技大學,學士班(日間),2953,1969,984
107,私立,技專校院,1060,南開科技大學,學士班(進修),756,483,273
107,私立,技專校院,1060,南開科技大學,碩士班(日間),105,66,39
107,私立,技專校院,1060,南開科技大學,碩士在職專班,99,33,66
107,私立,技專校院,1060,南開科技大學,附設進專,150,80,70
107,私立,技專校院,1060,南開科技大學,附設進院,121,61,60
107,私立,技專校院,1061,中華學校財團法人中華科技大學,學士班(日間),4371,2915,1456
107,私立,技專校院,1061,中華學校財團法人中華科技大學,學士班(進修),1142,840,302
107,私立,技專校院,1061,中華學校財團法人中華科技大學,碩士班(日間),200,144,56
107,私立,技專校院,1061,中華學校財團法人中華科技大學,碩士在職專班,97,75,22
107,私立,技專校院,1061,中華學校財團法人中華科技大學,附設進專,167,93,74
107,私立,技專校院,1062,僑光科技大學,二專(進修),5,3,2
107,私立,技專校院,1062,僑光科技大學,學士班(日間),6531,2633,3898
107,私立,技專校院,1062,僑光科技大學,學士班(進修),4349,2364,1985
107,私立,技專校院,1062,僑光科技大學,碩士班(日間),50,26,24
107,私立,技專校院,1062,僑光科技大學,碩士在職專班,35,22,13
107,私立,技專校院,1063,廣亞學校財團法人育達科技大學,二專(進修),15,0,15
107,私立,技專校院,1063,廣亞學校財團法人育達科技大學,學士班(日間),2446,1164,1282
107,私立,技專校院,1063,廣亞學校財團法人育達科技大學,學士班(進修),1991,945,1046
107,私立,技專校院,1063,廣亞學校財團法人育達科技大學,碩士班(日間),183,91,92
107,私立,技專校院,1063,廣亞學校財團法人育達科技大學,碩士在職專班,205,115,90
107,私立,技專校院,1064,美和學校財團法人美和科技大學,二專(進修),33,10,23
107,私立,技專校院,1064,美和學校財團法人美和科技大學,五專,1992,264,1728
107,私立,技專校院,1064,美和學校財團法人美和科技大學,學士班(日間),3392,1337,2055
107,私立,技專校院,1064,美和學校財團法人美和科技大學,學士班(進修),1620,409,1211
107,私立,技專校院,1064,美和學校財團法人美和科技大學,碩士班(日間),140,52,88
107,私立,技專校院,1064,美和學校財團法人美和科技大學,碩士在職專班,226,78,148
107,私立,技專校院,1064,美和學校財團法人美和科技大學,附設進專,269,136,133
107,私立,技專校院,1064,美和學校財團法人美和科技大學,附設進院,641,276,365
107,私立,技專校院,1065,吳鳳科技大學,學士班(日間),3388,2333,1055
107,私立,技專校院,1065,吳鳳科技大學,學士班(進修),841,612,229
107,私立,技專校院,1065,吳鳳科技大學,碩士班(日間),64,37,27
107,私立,技專校院,1065,吳鳳科技大學,碩士在職專班,67,29,38
107,私立,技專校院,1065,吳鳳科技大學,附設進專,192,122,70
107,私立,技專校院,1065,吳鳳科技大學,附設進院,686,318,368
107,私立,技專校院,1066,環球學校財團法人環球科技大學,二專(進修),206,104,102
107,私立,技專校院,1066,環球學校財團法人環球科技大學,學士班(日間),3010,1449,1561
107,私立,技專校院,1066,環球學校財團法人環球科技大學,學士班(進修),1361,603,758
107,私立,技專校院,1066,環球學校財團法人環球科技大學,碩士班(日間),149,61,88
107,私立,技專校院,1066,環球學校財團法人環球科技大學,碩士在職專班,50,29,21
107,私立,技專校院,1066,環球學校財團法人環球科技大學,附設進專,312,86,226
107,私立,技專校院,1066,環球學校財團法人環球科技大學,附設進院,206,54,152
107,私立,一般大學,1067,台灣首府學校財團法人台灣首府大學,學士班(日間),1758,877,881
107,私立,一般大學,1067,台灣首府學校財團法人台灣首府大學,學士班(進修),369,231,138
107,私立,一般大學,1067,台灣首府學校財團法人台灣首府大學,碩士班(日間),67,25,42
107,私立,技專校院,1068,中州學校財團法人中州科技大學,學士班(日間),1485,851,634
107,私立,技專校院,1068,中州學校財團法人中州科技大學,學士班(進修),1715,813,902
107,私立,技專校院,1068,中州學校財團法人中州科技大學,碩士班(日間),32,23,9
107,私立,技專校院,1068,中州學校財團法人中州科技大學,碩士在職專班,42,30,12
107,私立,技專校院,1068,中州學校財團法人中州科技大學,附設進專,109,28,81
107,私立,技專校院,1069,修平學校財團法人修平科技大學,學士班(日間),3746,2480,1266
107,私立,技專校院,1069,修平學校財團法人修平科技大學,學士班(進修),1065,932,133
107,私立,技專校院,1069,修平學校財團法人修平科技大學,碩士班(日間),57,41,16
107,私立,技專校院,1069,修平學校財團法人修平科技大學,碩士在職專班,9,8,1
107,私立,技專校院,1069,修平學校財團法人修平科技大學,附設進專,110,88,22
107,私立,技專校院,1069,修平學校財團法人修平科技大學,附設進院,298,215,83
107,私立,技專校院,1070,長庚學校財團法人長庚科技大學,五專,335,25,310
107,私立,技專校院,1070,長庚學校財團法人長庚科技大學,學士班(日間),4884,526,4358
107,私立,技專校院,1070,長庚學校財團法人長庚科技大學,學士班(進修),1251,84,1167
107,私立,技專校院,1070,長庚學校財團法人長庚科技大學,碩士班(日間),59,2,57
107,私立,技專校院,1070,長庚學校財團法人長庚科技大學,碩士在職專班,106,3,103
107,私立,技專校院,1071,城市學校財團法人臺北城市科技大學,二專(進修),12,7,5
107,私立,技專校院,1071,城市學校財團法人臺北城市科技大學,五專,1249,878,371
107,私立,技專校院,1071,城市學校財團法人臺北城市科技大學,學士班(日間),7162,4423,2739
107,私立,技專校院,1071,城市學校財團法人臺北城市科技大學,學士班(進修),852,622,230
107,私立,技專校院,1071,城市學校財團法人臺北城市科技大學,碩士班(日間),83,69,14
107,私立,技專校院,1071,城市學校財團法人臺北城市科技大學,附設進專,538,275,263
107,私立,技專校院,1071,城市學校財團法人臺北城市科技大學,附設進院,535,279,256
107,私立,技專校院,1072,大華學校財團法人大華科技大學,二專(進修),66,48,18
107,私立,技專校院,1072,大華學校財團法人大華科技大學,五專,518,307,211
107,私立,技專校院,1072,大華學校財團法人大華科技大學,學士班(日間),629,390,239
107,私立,技專校院,1072,大華學校財團法人大華科技大學,學士班(進修),797,543,254
107,私立,技專校院,1072,大華學校財團法人大華科技大學,碩士班(日間),9,9,0
107,私立,技專校院,1073,醒吾學校財團法人醒吾科技大學,五專,806,303,503
107,私立,技專校院,1073,醒吾學校財團法人醒吾科技大學,學士班(日間),5795,2425,3370
107,私立,技專校院,1073,醒吾學校財團法人醒吾科技大學,學士班(進修),1325,569,756
107,私立,技專校院,1073,醒吾學校財團法人醒吾科技大學,碩士班(日間),65,39,26
107,私立,技專校院,1073,醒吾學校財團法人醒吾科技大學,碩士在職專班,106,66,40
107,私立,技專校院,1073,醒吾學校財團法人醒吾科技大學,附設進專,398,204,194
107,私立,技專校院,1073,醒吾學校財團法人醒吾科技大學,附設進院,779,290,489
107,私立,技專校院,1074,南榮學校財團法人南榮科技大學,二專(進修),61,39,22
107,私立,技專校院,1074,南榮學校財團法人南榮科技大學,五專,108,79,29
107,私立,技專校院,1074,南榮學校財團法人南榮科技大學,學士班(日間),706,440,266
107,私立,技專校院,1074,南榮學校財團法人南榮科技大學,學士班(進修),720,503,217
107,私立,技專校院,1074,南榮學校財團法人南榮科技大學,碩士班(日間),27,18,9
107,私立,技專校院,1074,南榮學校財團法人南榮科技大學,碩士在職專班,28,12,16
107,私立,技專校院,1075,文藻學校財團法人文藻外語大學,五專,1625,280,1345
107,私立,技專校院,1075,文藻學校財團法人文藻外語大學,學士班(日間),5553,1336,4217
107,私立,技專校院,1075,文藻學校財團法人文藻外語大學,學士班(進修),2032,650,1382
107,私立,技專校院,1075,文藻學校財團法人文藻外語大學,碩士班(日間),174,43,131
107,私立,技專校院,1075,文藻學校財團法人文藻外語大學,碩士在職專班,53,15,38
107,私立,技專校院,1076,華夏學校財團法人華夏科技大學,二專(進修),234,102,132
107,私立,技專校院,1076,華夏學校財團法人華夏科技大學,五專,603,525,78
107,私立,技專校院,1076,華夏學校財團法人華夏科技大學,學士班(日間),2271,1449,822
107,私立,技專校院,1076,華夏學校財團法人華夏科技大學,學士班(進修),1151,660,491
107,私立,技專校院,1076,華夏學校財團法人華夏科技大學,碩士班(日間),41,35,6
107,私立,技專校院,1076,華夏學校財團法人華夏科技大學,碩士在職專班,66,48,18
107,私立,技專校院,1076,華夏學校財團法人華夏科技大學,附設進專,77,40,37
107,私立,技專校院,1076,華夏學校財團法人華夏科技大學,附設進院,132,82,50
107,私立,技專校院,1077,慈濟學校財團法人慈濟科技大學,五專,1293,166,1127
107,私立,技專校院,1077,慈濟學校財團法人慈濟科技大學,學士班(日間),1551,566,985
107,私立,技專校院,1077,慈濟學校財團法人慈濟科技大學,學士班(進修),96,9,87
107,私立,技專校院,1077,慈濟學校財團法人慈濟科技大學,碩士班(日間),39,16,23
107,私立,技專校院,1077,慈濟學校財團法人慈濟科技大學,附設進院,62,5,57
107,私立,技專校院,1078,致理學校財團法人致理科技大學,二專(日間),1,0,1
107,私立,技專校院,1078,致理學校財團法人致理科技大學,五專,1614,325,1289
107,私立,技專校院,1078,致理學校財團法人致理科技大學,學士班(日間),6584,2033,4551
107,私立,技專校院,1078,致理學校財團法人致理科技大學,學士班(進修),3213,1234,1979
107,私立,技專校院,1078,致理學校財團法人致理科技大學,碩士班(日間),47,10,37
107,私立,技專校院,1078,致理學校財團法人致理科技大學,碩士在職專班,50,15,35
107,私立,技專校院,1078,致理學校財團法人致理科技大學,附設進專,2,1,1
107,私立,技專校院,1078,致理學校財團法人致理科技大學,附設進院,2,2,0
107,私立,一般大學,1079,康寧學校財團法人康寧大學,二專(日間),1,0,1
107,私立,一般大學,1079,康寧學校財團法人康寧大學,二專(進修),273,61,212
107,私立,一般大學,1079,康寧學校財團法人康寧大學,五專,2863,637,2226
107,私立,一般大學,1079,康寧學校財團法人康寧大學,學士班(日間),607,287,320
107,私立,一般大學,1079,康寧學校財團法人康寧大學,學士班(進修),343,222,121
107,私立,一般大學,1079,康寧學校財團法人康寧大學,碩士班(日間),96,28,68
107,私立,一般大學,1079,康寧學校財團法人康寧大學,碩士在職專班,121,42,79
107,私立,技專校院,1080,宏國學校財團法人宏國德霖科技大學,二專(進修),185,89,96
107,私立,技專校院,1080,宏國學校財團法人宏國德霖科技大學,五專,1332,812,520
107,私立,技專校院,1080,宏國學校財團法人宏國德霖科技大學,學士班(日間),2685,1597,1088
107,私立,技專校院,1080,宏國學校財團法人宏國德霖科技大學,學士班(進修),2142,1323,819
107,私立,技專校院,1081,東方學校財團法人東方設計大學,五專,1193,547,646
107,私立,技專校院,1081,東方學校財團法人東方設計大學,學士班(日間),1262,681,581
107,私立,技專校院,1081,東方學校財團法人東方設計大學,學士班(進修),182,87,95
107,私立,技專校院,1081,東方學校財團法人東方設計大學,碩士班(日間),125,53,72
107,私立,技專校院,1081,東方學校財團法人東方設計大學,碩士在職專班,39,12,27
107,私立,技專校院,1081,東方學校財團法人東方設計大學,博士班,31,18,13
107,私立,技專校院,1081,東方學校財團法人東方設計大學,附設進專,459,225,234
107,私立,技專校院,1081,東方學校財團法人東方設計大學,附設進院,309,142,167
107,私立,技專校院,1082,崇右學校財團法人崇右影藝科技大學,五專,155,71,84
107,私立,技專校院,1082,崇右學校財團法人崇右影藝科技大學,學士班(日間),2174,985,1189
107,私立,技專校院,1082,崇右學校財團法人崇右影藝科技大學,碩士班(日間),86,45,41
107,私立,技專校院,1082,崇右學校財團法人崇右影藝科技大學,附設進專,466,249,217
107,私立,技專校院,1082,崇右學校財團法人崇右影藝科技大學,附設進院,536,230,306
107,私立,技專校院,1083,台北海洋學校財團法人台北海洋科技大學,二專(日間),73,69,4
107,私立,技專校院,1083,台北海洋學校財團法人台北海洋科技大學,二專(進修),85,78,7
107,私立,技專校院,1083,台北海洋學校財團法人台北海洋科技大學,五專,1058,645,413
107,私立,技專校院,1083,台北海洋學校財團法人台北海洋科技大學,學士班(日間),3244,1776,1468
107,私立,技專校院,1083,台北海洋學校財團法人台北海洋科技大學,學士班(進修),263,107,156
107,私立,技專校院,1083,台北海洋學校財團法人台北海洋科技大學,碩士班(日間),133,74,59
107,私立,技專校院,1083,台北海洋學校財團法人台北海洋科技大學,附設進專,51,15,36
107,私立,技專校院,1083,台北海洋學校財團法人台北海洋科技大學,附設進院,40,8,32
107,私立,一般大學,1125,中信學校財團法人中信金融管理學院,學士班(日間),588,292,296
107,私立,一般大學,1125,中信學校財團法人中信金融管理學院,碩士班(日間),73,38,35
107,私立,技專校院,1148,大漢技術學院,二專(進修),142,74,68
107,私立,技專校院,1148,大漢技術學院,學士班(日間),326,197,129
107,私立,技專校院,1148,大漢技術學院,學士班(進修),609,363,246
107,私立,技專校院,1148,大漢技術學院,碩士班(日間),86,62,24
107,私立,技專校院,1159,和春技術學院,二專(進修),241,171,70
107,私立,技專校院,1159,和春技術學院,五專,190,106,84
107,私立,技專校院,1159,和春技術學院,學士班(日間),398,274,124
107,私立,技專校院,1159,和春技術學院,學士班(進修),602,381,221
107,私立,技專校院,1159,和春技術學院,碩士班(日間),15,14,1
107,私立,技專校院,1159,和春技術學院,附設進專,53,32,21
107,私立,技專校院,1159,和春技術學院,附設進院,54,33,21
107,私立,技專校院,1166,亞東技術學院,學士班(日間),4367,3032,1335
107,私立,技專校院,1166,亞東技術學院,學士班(進修),112,2,110
107,私立,技專校院,1166,亞東技術學院,碩士班(日間),43,31,12
107,私立,技專校院,1168,南亞科技學校財團法人南亞技術學院,二專(進修),37,29,8
107,私立,技專校院,1168,南亞科技學校財團法人南亞技術學院,五專,327,181,146
107,私立,技專校院,1168,南亞科技學校財團法人南亞技術學院,學士班(日間),1763,1015,748
107,私立,技專校院,1168,南亞科技學校財團法人南亞技術學院,學士班(進修),857,598,259
107,私立,技專校院,1168,南亞科技學校財團法人南亞技術學院,碩士班(日間),26,21,5
107,私立,技專校院,1168,南亞科技學校財團法人南亞技術學院,附設進專,146,91,55
107,私立,技專校院,1168,南亞科技學校財團法人南亞技術學院,附設進院,813,319,494
107,私立,一般大學,1176,稻江科技暨管理學院,學士班(日間),1455,773,682
107,私立,一般大學,1176,稻江科技暨管理學院,學士班(進修),739,253,486
107,私立,一般大學,1176,稻江科技暨管理學院,碩士班(日間),85,42,43
107,私立,一般大學,1176,稻江科技暨管理學院,碩士在職專班,55,34,21
107,私立,技專校院,1182,蘭陽技術學院,五專,405,239,166
107,私立,技專校院,1182,蘭陽技術學院,學士班(日間),516,302,214
107,私立,技專校院,1182,蘭陽技術學院,附設進專,124,78,46
107,私立,技專校院,1182,蘭陽技術學院,附設進院,268,147,121
107,私立,技專校院,1183,黎明技術學院,二專(進修),62,2,60
107,私立,技專校院,1183,黎明技術學院,五專,583,494,89
107,私立,技專校院,1183,黎明技術學院,學士班(日間),3326,1771,1555
107,私立,技專校院,1183,黎明技術學院,學士班(進修),954,576,378
107,私立,技專校院,1185,經國管理暨健康學院,五專,1305,346,959
107,私立,技專校院,1185,經國管理暨健康學院,學士班(日間),2059,703,1356
107,私立,技專校院,1185,經國管理暨健康學院,學士班(進修),297,78,219
107,私立,技專校院,1185,經國管理暨健康學院,碩士班(日間),26,6,20
107,私立,技專校院,1185,經國管理暨健康學院,碩士在職專班,45,8,37
107,私立,技專校院,1185,經國管理暨健康學院,附設進專,277,62,215
107,私立,技專校院,1185,經國管理暨健康學院,附設進院,605,113,492
107,私立,技專校院,1188,大同技術學院,二專(進修),6,3,3
107,私立,技專校院,1188,大同技術學院,五專,135,76,59
107,私立,技專校院,1188,大同技術學院,學士班(日間),1110,519,591
107,私立,技專校院,1188,大同技術學院,學士班(進修),552,177,375
107,私立,技專校院,1188,大同技術學院,附設進專,88,26,62
107,私立,技專校院,1192,臺灣觀光學院,二專(日間),1,1,0
107,私立,技專校院,1192,臺灣觀光學院,二專(進修),39,15,24
107,私立,技專校院,1192,臺灣觀光學院,五專,133,51,82
107,私立,技專校院,1192,臺灣觀光學院,學士班(日間),413,217,196
107,私立,技專校院,1192,臺灣觀光學院,學士班(進修),137,54,83
107,私立,技專校院,1192,臺灣觀光學院,碩士班(日間),28,13,15
107,私立,一般大學,1195,馬偕學校財團法人馬偕醫學院,學士班(日間),661,254,407
107,私立,一般大學,1195,馬偕學校財團法人馬偕醫學院,碩士班(日間),47,19,28
107,私立,一般大學,1196,法鼓學校財團法人法鼓文理學院,學士班(日間),57,21,36
107,私立,一般大學,1196,法鼓學校財團法人法鼓文理學院,碩士班(日間),206,54,152
107,私立,一般大學,1196,法鼓學校財團法人法鼓文理學院,博士班,17,7,10
107,私立,技專校院,1282,馬偕學校財團法人馬偕醫護管理專科學校,二專(日間),42,19,23
107,私立,技專校院,1282,馬偕學校財團法人馬偕醫護管理專科學校,二專(進修),302,148,154
107,私立,技專校院,1282,馬偕學校財團法人馬偕醫護管理專科學校,五專,3932,448,3484
107,私立,技專校院,1283,仁德醫護管理專科學校,二專(進修),352,202,150
107,私立,技專校院,1283,仁德醫護管理專科學校,五專,6073,1308,4765
107,私立,技專校院,1284,樹人醫護管理專科學校,二專(進修),529,340,189
107,私立,技專校院,1284,樹人醫護管理專科學校,五專,6620,1548,5072
107,私立,技專校院,1285,慈惠醫護管理專科學校,二專(日間),96,36,60
107,私立,技專校院,1285,慈惠醫護管理專科學校,二專(進修),267,97,170
107,私立,技專校院,1285,慈惠醫護管理專科學校,五專,4677,1059,3618
107,私立,技專校院,1286,耕莘健康管理專科學校,二專(進修),106,1,105
107,私立,技專校院,1286,耕莘健康管理專科學校,五專,4987,506,4481
107,私立,技專校院,1287,敏惠醫護管理專科學校,五專,3869,470,3399
107,私立,技專校院,1289,育英醫護管理專科學校,五專,2013,202,1811
107,私立,技專校院,1291,聖母醫護管理專科學校,五專,2777,588,2189
107,私立,技專校院,1292,新生醫護管理專科學校,二專(進修),94,35,59
107,私立,技專校院,1292,新生醫護管理專科學校,五專,5964,723,5241
107,私立,技專校院,1293,崇仁醫護管理專科學校,五專,3392,418,2974
107,私立,宗教研修學院,1R02,學校財團法人中華浸信會基督教台灣浸會神學院,碩士班(日間),31,13,18
107,私立,宗教研修學院,1R03,臺北基督學院,學士班(日間),89,37,52
107,私立,宗教研修學院,1R04,財團法人一貫道天皇基金會一貫道天皇學院,學士班(日間),61,26,35
107,私立,宗教研修學院,1R04,財團法人一貫道天皇基金會一貫道天皇學院,碩士班(日間),37,13,24
107,私立,宗教研修學院,1R04,財團法人一貫道天皇基金會一貫道天皇學院,碩士在職專班,30,14,16
107,私立,宗教研修學院,1R05,台神學校財團法人台灣神學研究學院,碩士班(日間),93,39,54
107,私立,宗教研修學院,1R06,一貫道崇德學院,碩士班(日間),50,24,26
107,私立,宗教研修學院,1R07,台灣基督長老教會南神神學院,碩士班(日間),47,16,31
107,公立,一般大學,3002,臺北市立大學,學士班(日間),5304,2373,2931
107,公立,一般大學,3002,臺北市立大學,碩士班(日間),1187,388,799
107,公立,一般大學,3002,臺北市立大學,碩士在職專班,1036,287,749
107,公立,一般大學,3002,臺北市立大學,博士班,247,103,144
 ,,,,,,,,
統計說明,,,,,,,,
一、學年度：係指【學年度】為篩選條件。,,,,,,,,
二、設立別：係指【公立、私立】大學校院等分類。,,,,,,,,
三、學校類別：係指【一般大學、技專校院、宗教研修學院】等。,,,,,,,,
四、學校名稱：係指【學校校名】。,,,,,,,,
五、學制班別：,,,,,,,,
1.	係指【二專(日間)、二專(進修)、五專(含七)、學士班(日間)、學士班(進修)、碩士班(日間)、碩士在職專班、博士班、附設進院、附設進專】；其中學士班(日間)及學士班(進修)包含大學四年制(或四技)、大學二年制(或二技)及學士後第二專長學位學程。,,,,,,,,
2.	本表「五專(含七)」包括五專及七年一貫制，其中「七年一貫」係指：,,,,,,,,
(1)	藝術大學藝術類科「七年一貫」學制之前3年(後四年歸屬為「大學四年制」)。,,,,,,,,
(2)	技專校院「七年一貫」學制之前5年(後二年歸屬為「二技」)。,,,,,,,,
六、在學學生數：,,,,,,,,
1.	係指學校當學年度(10月15日)具備正式學籍之在學學生【男、女】總人數，包括本國籍學生、僑生、外國學生(含雙聯學制學生)、大陸地區來臺就讀之學位生等；但不包括選讀生、休退學生、學分班、交換生(非學位生)、保留入學資格或無學籍學生等。,,,,,,,,
2.	本表106學年度在學學生數不包括「附設進修專校及附設進修學院」人數，若須查詢請見網址：http://stats.moe.gov.tw/files/ebook/higher/106/106_highera-temp.xls。自107學年度起將增列「附設進修專校及附設進修學院」等二類學制班別之在學學生人數(不含國立臺北商業大學附設空中進修學院及國立臺中科技大學附設空中進修學院)。,,,,,,,,
七、資料來源：資料由【教育部高教司大學校院校務資料庫】之「學1.正式學籍在學學生人數統計表」、【教育部技職司技專校院校務資料庫】之「表4-2 各年級實際在學學生人數」產出，並由【教育部統計處】彙整提供，以每年10月15日為統計基準日。,,,,,,,,
